DOCUMENTO;FECHA;ID_CLIENTE;TIPO_DOCUMENTO;ID_VENDEDOR;CANAL_ID;TOTAL_NETO;IMPUESTO;TOTAL_DOCUMENTO
FAC0030000;2015-05-31;CLI00530;FACTURA;41;1;142540;27083;169623
FAC0030001;2015-06-03;CLI00867;FACTURA;29;2;84610;16076;100686
FAC0030002;2015-08-23;CLI00892;FACTURA;35;1;277680;52759;330439
FAC0030003;2015-12-19;CLI00789;FACTURA;48;2;50596;9613;60209
FAC0030004;2015-05-27;CLI00673;FACTURA;1;2;57336;10894;68230
FAC0030005;2015-11-17;CLI00630;FACTURA;48;1;21805;4143;25948
FAC0030006;2015-06-06;CLI00583;FACTURA;46;2;192690;36611;229301
FAC0030007;2015-11-10;CLI00190;FACTURA;48;1;32272;6132;38404
FAC0030008;2015-05-12;CLI00675;FACTURA;34;2;141029;26796;167825
FAC0030009;2015-01-21;CLI00548;FACTURA;27;1;159498;30305;189803
FAC0030010;2015-05-30;CLI00662;FACTURA;35;1;15892;3019;18911
FAC0030011;2015-01-09;CLI00507;FACTURA;17;2;123065;23382;146447
FAC0030012;2015-01-05;CLI00162;FACTURA;45;1;21097;4008;25105
FAC0030013;2015-08-26;CLI00168;FACTURA;48;1;216568;41148;257716
FAC0030014;2015-05-03;CLI00883;FACTURA;29;2;56222;10682;66904
FAC0030015;2015-05-03;CLI00434;FACTURA;26;1;31437;5973;37410
FAC0030016;2015-12-07;CLI00002;FACTURA;16;1;37932;7207;45139
FAC0030017;2015-12-07;CLI00968;FACTURA;50;1;51005;9691;60696
FAC0030018;2015-09-16;CLI00983;FACTURA;37;2;16035;3047;19082
FAC0030019;2015-09-07;CLI00134;FACTURA;40;1;217944;41409;259353
FAC0030020;2015-03-21;CLI00309;FACTURA;42;2;177648;33753;211401
FAC0030021;2015-11-13;CLI00971;FACTURA;29;2;217944;41409;259353
FAC0030022;2015-04-04;CLI00381;FACTURA;26;2;216568;41148;257716
FAC0030023;2015-09-17;CLI00973;FACTURA;1;2;13674;2598;16272
FAC0030024;2015-05-13;CLI00839;FACTURA;37;2;71670;13617;85287
FAC0030025;2015-01-27;CLI00141;FACTURA;41;2;67688;12861;80549
FAC0030026;2015-01-22;CLI00995;FACTURA;9;2;55530;10551;66081
FAC0030027;2015-06-04;CLI00850;FACTURA;1;1;81729;15529;97258
FAC0030028;2015-12-27;CLI00523;FACTURA;42;2;140555;26705;167260
FAC0030029;2015-03-09;CLI00164;FACTURA;35;1;21410;4068;25478
FAC0030030;2015-02-25;CLI00864;FACTURA;39;1;161176;30623;191799
FAC0030031;2015-02-26;CLI00756;FACTURA;37;1;128460;24407;152867
FAC0030032;2015-05-29;CLI00571;FACTURA;47;2;47668;9057;56725
FAC0030033;2015-07-28;CLI00423;FACTURA;32;2;181112;34411;215523
FAC0030034;2015-11-07;CLI00496;FACTURA;27;1;100735;19140;119875
FAC0030035;2015-10-29;CLI00776;FACTURA;39;1;228654;43444;272098
FAC0030036;2015-08-24;CLI00884;FACTURA;42;1;224888;42729;267617
FAC0030037;2015-10-19;CLI00944;FACTURA;39;1;79460;15097;94557
FAC0030038;2015-06-01;CLI00518;FACTURA;47;1;52908;10053;62961
FAC0030039;2015-12-17;CLI00672;FACTURA;23;1;167985;31917;199902
FAC0030040;2015-02-01;CLI00151;FACTURA;46;2;114540;21763;136303
FAC0030041;2015-01-16;CLI00090;FACTURA;37;1;120882;22968;143850
FAC0030042;2015-06-15;CLI00358;FACTURA;49;1;21117;4012;25129
FAC0030043;2015-08-12;CLI00004;FACTURA;30;1;249381;47382;296763
FAC0030044;2015-04-01;CLI00462;FACTURA;7;1;186081;35355;221436
FAC0030045;2015-11-13;CLI00342;FACTURA;13;1;80178;15234;95412
FAC0030046;2015-01-16;CLI00187;FACTURA;40;2;347100;65949;413049
FAC0030047;2015-12-21;CLI00844;FACTURA;4;1;81729;15529;97258
FAC0030048;2015-01-27;CLI00585;FACTURA;20;2;81213;15430;96643
FAC0030049;2015-07-30;CLI00159;FACTURA;47;2;63568;12078;75646
FAC0030050;2015-02-23;CLI00637;FACTURA;37;2;249381;47382;296763
FAC0030051;2015-09-17;CLI00098;FACTURA;10;1;47415;9009;56424
FAC0030052;2015-07-06;CLI00600;FACTURA;13;1;186081;35355;221436
FAC0030053;2015-08-14;CLI00624;FACTURA;6;1;163458;31057;194515
FAC0030054;2015-07-20;CLI00180;FACTURA;26;1;138545;26324;164869
FAC0030055;2015-09-03;CLI00811;FACTURA;1;2;34804;6613;41417
FAC0030056;2015-08-10;CLI00187;FACTURA;46;2;56380;10712;67092
FAC0030057;2015-07-28;CLI00845;FACTURA;7;2;20343;3865;24208
FAC0030058;2015-12-14;CLI00656;FACTURA;47;1;151176;28723;179899
FAC0030059;2015-08-22;CLI00527;FACTURA;36;2;190053;36110;226163
FAC0030060;2015-09-26;CLI00486;FACTURA;34;1;145015;27553;172568
FAC0030061;2015-08-11;CLI00843;FACTURA;6;2;190053;36110;226163
FAC0030062;2015-01-31;CLI00116;FACTURA;12;1;123065;23382;146447
FAC0030063;2015-03-02;CLI00484;FACTURA;50;1;33828;6427;40255
FAC0030064;2015-12-05;CLI00625;FACTURA;46;2;94485;17952;112437
FAC0030065;2015-04-05;CLI00481;FACTURA;29;2;33792;6420;40212
FAC0030066;2015-01-23;CLI00869;FACTURA;22;2;243639;46291;289930
FAC0030067;2015-01-22;CLI00913;FACTURA;3;2;105485;20042;125527
FAC0030068;2015-12-02;CLI00013;FACTURA;3;2;147678;28059;175737
FAC0030069;2015-03-07;CLI00514;FACTURA;47;1;136740;25981;162721
FAC0030070;2015-07-21;CLI00803;FACTURA;43;2;25473;4840;30313
FAC0030071;2015-05-06;CLI00207;FACTURA;32;2;47676;9058;56734
FAC0030072;2015-08-01;CLI00980;FACTURA;11;1;193963;36853;230816
FAC0030073;2015-02-13;CLI00934;FACTURA;3;1;172676;32808;205484
FAC0030074;2015-02-23;CLI00656;FACTURA;20;1;114672;21788;136460
FAC0030075;2015-06-20;CLI00940;FACTURA;34;1;12340;2345;14685
FAC0030076;2015-05-11;CLI00337;FACTURA;17;2;34187;6496;40683
FAC0030077;2015-04-26;CLI00546;FACTURA;26;1;256572;48749;305321
FAC0030078;2015-01-31;CLI00262;FACTURA;24;1;25406;4827;30233
FAC0030079;2015-10-29;CLI00410;FACTURA;19;1;9483;1802;11285
FAC0030080;2015-02-24;CLI00707;FACTURA;26;2;203751;38713;242464
FAC0030081;2015-02-16;CLI00487;FACTURA;11;2;50766;9646;60412
FAC0030082;2015-05-21;CLI00362;FACTURA;26;1;25473;4840;30313
FAC0030083;2015-07-19;CLI00086;FACTURA;7;1;43253;8218;51471
FAC0030084;2015-03-29;CLI00913;FACTURA;12;2;45746;8692;54438
FAC0030085;2015-12-30;CLI00794;FACTURA;47;1;57270;10881;68151
FAC0030086;2015-06-14;CLI00244;FACTURA;31;1;123452;23456;146908
FAC0030087;2015-04-15;CLI00110;FACTURA;16;1;55611;10566;66177
FAC0030088;2015-11-24;CLI00278;FACTURA;32;1;105485;20042;125527
FAC0030089;2015-09-11;CLI00829;FACTURA;10;2;169220;32152;201372
FAC0030090;2015-07-15;CLI00894;FACTURA;46;1;222012;42182;264194
FAC0030091;2015-10-20;CLI00975;FACTURA;9;2;63291;12025;75316
FAC0030092;2015-08-30;CLI00588;FACTURA;17;1;39730;7549;47279
FAC0030093;2015-02-24;CLI00283;FACTURA;3;2;91809;17444;109253
FAC0030094;2015-08-10;CLI00924;FACTURA;41;1;67688;12861;80549
FAC0030095;2015-12-04;CLI00656;FACTURA;22;1;33844;6430;40274
FAC0030096;2015-05-21;CLI00404;FACTURA;32;1;113195;21507;134702
FAC0030097;2015-05-24;CLI00201;FACTURA;35;2;67584;12841;80425
FAC0030098;2015-08-17;CLI00683;FACTURA;6;2;217944;41409;259353
FAC0030099;2015-12-12;CLI00719;FACTURA;26;2;25406;4827;30233
FAC0030100;2015-04-28;CLI00564;FACTURA;39;1;61029;11596;72625
FAC0030101;2015-09-14;CLI00575;FACTURA;38;2;246680;46869;293549
FAC0030102;2015-04-23;CLI00894;FACTURA;20;1;161176;30623;191799
FAC0030103;2015-08-29;CLI00360;FACTURA;11;1;226390;43014;269404
FAC0030104;2015-03-10;CLI00249;FACTURA;10;2;6170;1172;7342
FAC0030105;2015-11-17;CLI00799;FACTURA;22;2;60441;11484;71925
FAC0030106;2015-11-29;CLI00900;FACTURA;30;1;27243;5176;32419
FAC0030107;2015-07-19;CLI00611;FACTURA;40;2;80175;15233;95408
FAC0030108;2015-09-20;CLI00080;FACTURA;50;1;281110;53411;334521
FAC0030109;2015-11-23;CLI00470;FACTURA;2;1;55611;10566;66177
FAC0030110;2015-09-16;CLI00613;FACTURA;39;2;127030;24136;151166
FAC0030111;2015-10-02;CLI00908;FACTURA;3;1;27071;5143;32214
FAC0030112;2015-10-18;CLI00340;FACTURA;40;1;64140;12187;76327
FAC0030113;2015-09-04;CLI00479;FACTURA;40;2;277680;52759;330439
FAC0030114;2015-12-13;CLI00941;FACTURA;29;2;243628;46289;289917
FAC0030115;2015-05-13;CLI00615;FACTURA;40;2;107050;20340;127390
FAC0030116;2015-03-31;CLI00039;FACTURA;39;2;161360;30658;192018
FAC0030117;2015-06-10;CLI00945;FACTURA;45;2;73353;13937;87290
FAC0030118;2015-07-15;CLI00039;FACTURA;23;2;104790;19910;124700
FAC0030119;2015-05-16;CLI00308;FACTURA;22;1;170935;32478;203413
FAC0030120;2015-01-18;CLI00691;FACTURA;29;2;70544;13403;83947
FAC0030121;2015-05-11;CLI00690;FACTURA;36;1;53166;10102;63268
FAC0030122;2015-08-11;CLI00213;FACTURA;31;2;80175;15233;95408
FAC0030123;2015-07-16;CLI00864;FACTURA;47;1;205122;38973;244095
FAC0030124;2015-08-28;CLI00622;FACTURA;31;1;270710;51435;322145
FAC0030125;2015-06-19;CLI00963;FACTURA;22;2;214100;40679;254779
FAC0030126;2015-10-07;CLI00873;FACTURA;26;2;91492;17383;108875
FAC0030127;2015-09-24;CLI00544;FACTURA;41;1;136740;25981;162721
FAC0030128;2015-07-08;CLI00407;FACTURA;28;2;61206;11629;72835
FAC0030129;2015-03-23;CLI00569;FACTURA;3;2;105585;20061;125646
FAC0030130;2015-04-22;CLI00821;FACTURA;5;2;63351;12037;75388
FAC0030131;2015-01-31;CLI00634;FACTURA;35;1;76032;14446;90478
FAC0030132;2015-09-04;CLI00651;FACTURA;7;2;145015;27553;172568
FAC0030133;2015-05-21;CLI01000;FACTURA;23;1;278432;52902;331334
FAC0030134;2015-10-20;CLI00371;FACTURA;50;2;28190;5356;33546
FAC0030135;2015-02-19;CLI00154;FACTURA;12;1;42234;8024;50258
FAC0030136;2015-02-04;CLI00313;FACTURA;15;2;71670;13617;85287
FAC0030137;2015-08-12;CLI00553;FACTURA;20;2;84388;16034;100422
FAC0030138;2015-04-19;CLI00061;FACTURA;27;2;39466;7499;46965
FAC0030139;2015-04-09;CLI00730;FACTURA;37;1;40584;7711;48295
FAC0030140;2015-12-26;CLI00287;FACTURA;19;2;55622;10568;66190
FAC0030141;2015-01-14;CLI00514;FACTURA;11;1;168666;32047;200713
FAC0030142;2015-09-17;CLI00682;FACTURA;4;1;24680;4689;29369
FAC0030143;2015-10-07;CLI00560;FACTURA;27;1;26583;5051;31634
FAC0030144;2015-01-04;CLI00793;FACTURA;43;2;25344;4815;30159
FAC0030145;2015-01-23;CLI00380;FACTURA;45;1;35751;6793;42544
FAC0030146;2015-08-22;CLI00497;FACTURA;6;2;277090;52647;329737
FAC0030147;2015-11-12;CLI00050;FACTURA;33;1;114672;21788;136460
FAC0030148;2015-10-22;CLI00390;FACTURA;34;1;114032;21666;135698
FAC0030149;2015-09-27;CLI00424;FACTURA;30;1;50946;9680;60626
FAC0030150;2015-01-26;CLI00246;FACTURA;43;1;139216;26451;165667
FAC0030151;2015-06-13;CLI00901;FACTURA;17;2;91809;17444;109253
FAC0030152;2015-01-07;CLI00324;FACTURA;5;1;25344;4815;30159
FAC0030153;2015-03-31;CLI00827;FACTURA;1;2;189873;36076;225949
FAC0030154;2015-10-11;CLI00468;FACTURA;22;1;27709;5265;32974
FAC0030155;2015-12-11;CLI00789;FACTURA;34;2;70544;13403;83947
FAC0030156;2015-01-27;CLI00187;FACTURA;12;2;71502;13585;85087
FAC0030157;2015-09-11;CLI00527;FACTURA;47;2;53166;10102;63268
FAC0030158;2015-12-04;CLI00254;FACTURA;46;1;197344;37495;234839
FAC0030159;2015-07-25;CLI00776;FACTURA;23;1;30895;5870;36765
FAC0030160;2015-09-22;CLI00098;FACTURA;35;1;152838;29039;181877
FAC0030161;2015-10-30;CLI00546;FACTURA;28;1;203248;38617;241865
FAC0030162;2015-06-13;CLI00206;FACTURA;32;1;12340;2345;14685
FAC0030163;2015-08-25;CLI00383;FACTURA;40;2;131064;24902;155966
FAC0030164;2015-03-31;CLI00535;FACTURA;17;2;94485;17952;112437
FAC0030165;2015-09-03;CLI00258;FACTURA;43;1;11454;2176;13630
FAC0030166;2015-11-06;CLI00115;FACTURA;15;2;256572;48749;305321
FAC0030167;2015-11-23;CLI00546;FACTURA;48;1;252980;48066;301046
FAC0030168;2015-07-10;CLI00311;FACTURA;28;2;97530;18531;116061
FAC0030169;2015-11-04;CLI00843;FACTURA;13;2;16922;3215;20137
FAC0030170;2015-06-08;CLI00922;FACTURA;18;1;28508;5417;33925
FAC0030171;2015-04-24;CLI00087;FACTURA;6;2;142401;27056;169457
FAC0030172;2015-06-24;CLI00285;FACTURA;3;2;22639;4301;26940
FAC0030173;2015-08-13;CLI00088;FACTURA;23;1;243628;46289;289917
FAC0030174;2015-09-01;CLI00091;FACTURA;25;2;16035;3047;19082
FAC0030175;2015-04-02;CLI00892;FACTURA;1;1;79749;15152;94901
FAC0030176;2015-12-12;CLI00425;FACTURA;41;2;347100;65949;413049
FAC0030177;2015-09-26;CLI00470;FACTURA;37;1;141029;26796;167825
FAC0030178;2015-10-09;CLI00019;FACTURA;9;2;57270;10881;68151
FAC0030179;2015-12-17;CLI00160;FACTURA;30;1;102010;19382;121392
FAC0030180;2015-06-05;CLI00245;FACTURA;33;2;32272;6132;38404
FAC0030181;2015-03-13;CLI00403;FACTURA;32;2;114672;21788;136460
FAC0030182;2015-01-03;CLI00624;FACTURA;20;1;171280;32543;203823
FAC0030183;2015-11-10;CLI00988;FACTURA;20;1;63291;12025;75316
FAC0030184;2015-05-16;CLI00480;FACTURA;19;1;43718;8306;52024
FAC0030185;2015-11-19;CLI00936;FACTURA;3;1;84610;16076;100686
FAC0030186;2015-05-16;CLI00095;FACTURA;29;2;227682;43260;270942
FAC0030187;2015-07-22;CLI00233;FACTURA;12;2;52908;10053;62961
FAC0030188;2015-06-18;CLI00852;FACTURA;6;1;31437;5973;37410
FAC0030189;2015-01-11;CLI00050;FACTURA;48;1;28668;5447;34115
FAC0030190;2015-12-14;CLI00998;FACTURA;3;1;112245;21327;133572
FAC0030191;2015-02-15;CLI00054;FACTURA;39;1;265830;50508;316338
FAC0030192;2015-03-27;CLI00458;FACTURA;25;1;87436;16613;104049
FAC0030193;2015-10-04;CLI00255;FACTURA;50;2;88824;16877;105701
FAC0030194;2015-10-22;CLI00562;FACTURA;40;1;56898;10811;67709
FAC0030195;2015-10-26;CLI00330;FACTURA;43;1;84388;16034;100422
FAC0030196;2015-08-19;CLI00021;FACTURA;39;2;199556;37916;237472
FAC0030197;2015-08-07;CLI00107;FACTURA;16;2;79749;15152;94901
FAC0030198;2015-08-16;CLI00071;FACTURA;41;2;199556;37916;237472
FAC0030199;2015-10-10;CLI00105;FACTURA;45;2;57336;10894;68230
FAC0030200;2015-09-06;CLI00334;FACTURA;27;1;208824;39677;248501
FAC0030201;2015-08-15;CLI00395;FACTURA;7;2;212664;40406;253070
FAC0030202;2015-01-23;CLI00084;FACTURA;36;1;40294;7656;47950
FAC0030203;2015-08-05;CLI00982;FACTURA;24;1;61700;11723;73423
FAC0030204;2015-02-15;CLI00641;FACTURA;8;2;22552;4285;26837
FAC0030205;2015-09-19;CLI00698;FACTURA;12;1;174020;33064;207084
FAC0030206;2015-04-28;CLI00791;FACTURA;5;2;91492;17383;108875
FAC0030207;2015-06-08;CLI00324;FACTURA;28;1;111030;21096;132126
FAC0030208;2015-03-30;CLI00660;FACTURA;19;1;37784;7179;44963
FAC0030209;2015-10-05;CLI00707;FACTURA;5;2;84610;16076;100686
FAC0030210;2015-04-11;CLI00017;FACTURA;34;2;76032;14446;90478
FAC0030211;2015-01-26;CLI00255;FACTURA;2;2;128460;24407;152867
FAC0030212;2015-11-22;CLI00319;FACTURA;4;2;120882;22968;143850
FAC0030213;2015-05-04;CLI00643;FACTURA;3;2;270710;51435;322145
FAC0030214;2015-11-07;CLI00402;FACTURA;36;1;56898;10811;67709
FAC0030215;2015-09-02;CLI00942;FACTURA;40;1;189873;36076;225949
FAC0030216;2015-03-08;CLI00036;FACTURA;29;1;172291;32735;205026
FAC0030217;2015-06-13;CLI00704;FACTURA;2;1;75894;14420;90314
FAC0030218;2015-10-03;CLI00066;FACTURA;24;1;42194;8017;50211
FAC0030219;2015-03-27;CLI00128;FACTURA;28;1;57270;10881;68151
FAC0030220;2015-06-15;CLI00910;FACTURA;33;1;96816;18395;115211
FAC0030221;2015-11-27;CLI00288;FACTURA;45;1;94485;17952;112437
FAC0030222;2015-02-02;CLI00551;FACTURA;5;2;101192;19226;120418
FAC0030223;2015-11-04;CLI00766;FACTURA;40;1;151788;28840;180628
FAC0030224;2015-04-19;CLI00842;FACTURA;46;1;94460;17947;112407
FAC0030225;2015-01-02;CLI00280;FACTURA;22;1;14334;2723;17057
FAC0030226;2015-04-29;CLI00032;FACTURA;18;1;66381;12612;78993
FAC0030227;2015-10-29;CLI00157;FACTURA;19;2;327660;62255;389915
FAC0030228;2015-08-22;CLI00013;FACTURA;29;2;37794;7181;44975
FAC0030229;2015-05-08;CLI00290;FACTURA;3;1;74004;14061;88065
FAC0030230;2015-08-03;CLI00808;FACTURA;47;1;78024;14825;92849
FAC0030231;2015-09-13;CLI00594;FACTURA;32;1;44412;8438;52850
FAC0030232;2015-12-23;CLI00243;FACTURA;50;2;22908;4353;27261
FAC0030233;2015-03-29;CLI00517;FACTURA;17;2;108284;20574;128858
FAC0030234;2015-03-24;CLI00592;FACTURA;33;1;161176;30623;191799
FAC0030235;2015-07-05;CLI00524;FACTURA;40;1;190053;36110;226163
FAC0030236;2015-12-21;CLI00487;FACTURA;41;2;43190;8206;51396
FAC0030237;2015-01-10;CLI00884;FACTURA;10;1;174020;33064;207084
FAC0030238;2015-04-14;CLI00928;FACTURA;26;1;65415;12429;77844
FAC0030239;2015-10-02;CLI00045;FACTURA;25;2;133236;25315;158551
FAC0030240;2015-04-15;CLI00564;FACTURA;4;1;216568;41148;257716
FAC0030241;2015-07-08;CLI00748;FACTURA;33;1;64230;12204;76434
FAC0030242;2015-10-17;CLI00583;FACTURA;47;2;144315;27420;171735
FAC0030243;2015-12-01;CLI00356;FACTURA;25;1;186081;35355;221436
FAC0030244;2015-03-17;CLI00837;FACTURA;36;2;68619;13038;81657
FAC0030245;2015-01-15;CLI00781;FACTURA;12;2;136740;25981;162721
FAC0030246;2015-03-12;CLI00819;FACTURA;17;2;68724;13058;81782
FAC0030247;2015-05-20;CLI00477;FACTURA;15;2;80178;15234;95412
FAC0030248;2015-08-02;CLI00207;FACTURA;11;2;75894;14420;90314
FAC0030249;2015-09-25;CLI00149;FACTURA;50;2;68619;13038;81657
FAC0030250;2015-04-28;CLI00738;FACTURA;29;1;57336;10894;68230
FAC0030251;2015-04-12;CLI00221;FACTURA;15;2;222012;42182;264194
FAC0030252;2015-10-21;CLI00193;FACTURA;18;2;27709;5265;32974
FAC0030253;2015-05-30;CLI00525;FACTURA;33;2;13674;2598;16272
FAC0030254;2015-03-30;CLI00393;FACTURA;44;2;277680;52759;330439
FAC0030255;2015-09-19;CLI00559;FACTURA;47;2;48408;9198;57606
FAC0030256;2015-04-23;CLI00366;FACTURA;14;1;108284;20574;128858
FAC0030257;2015-01-29;CLI00689;FACTURA;5;2;40686;7730;48416
FAC0030258;2015-04-10;CLI00551;FACTURA;4;2;239309;45469;284778
FAC0030259;2015-11-04;CLI00206;FACTURA;10;1;25344;4815;30159
FAC0030260;2015-03-24;CLI00652;FACTURA;7;1;176360;33508;209868
FAC0030261;2015-09-29;CLI00483;FACTURA;32;2;136748;25982;162730
FAC0030262;2015-01-25;CLI00893;FACTURA;3;2;341870;64955;406825
FAC0030263;2015-06-01;CLI00781;FACTURA;28;2;39730;7549;47279
FAC0030264;2015-11-26;CLI00715;FACTURA;32;2;83419;15850;99269
FAC0030265;2015-01-16;CLI00545;FACTURA;15;2;75864;14414;90278
FAC0030266;2015-05-06;CLI01000;FACTURA;13;1;48105;9140;57245
FAC0030267;2015-11-27;CLI00855;FACTURA;6;2;168776;32067;200843
FAC0030268;2015-01-03;CLI00827;FACTURA;28;2;66122;12563;78685
FAC0030269;2015-08-12;CLI00817;FACTURA;33;2;80178;15234;95412
FAC0030270;2015-11-13;CLI00375;FACTURA;47;2;218050;41430;259480
FAC0030271;2015-07-20;CLI00866;FACTURA;39;1;74004;14061;88065
FAC0030272;2015-11-14;CLI00047;FACTURA;47;2;97530;18531;116061
FAC0030273;2015-01-20;CLI00594;FACTURA;38;1;15892;3019;18911
FAC0030274;2015-12-24;CLI00045;FACTURA;50;2;122058;23191;145249
FAC0030275;2015-09-24;CLI00464;FACTURA;2;1;214100;40679;254779
FAC0030276;2015-10-01;CLI00691;FACTURA;4;2;168666;32047;200713
FAC0030277;2015-07-24;CLI00662;FACTURA;30;1;222060;42191;264251
FAC0030278;2015-10-06;CLI00618;FACTURA;2;1;199854;37972;237826
FAC0030279;2015-10-31;CLI00900;FACTURA;14;1;245187;46586;291773
FAC0030280;2015-10-03;CLI00753;FACTURA;7;2;205122;38973;244095
FAC0030281;2015-09-03;CLI00310;FACTURA;41;1;87436;16613;104049
FAC0030282;2015-05-09;CLI00067;FACTURA;47;2;84333;16023;100356
FAC0030283;2015-07-14;CLI00834;FACTURA;17;1;34362;6529;40891
FAC0030284;2015-01-18;CLI00815;FACTURA;45;2;22873;4346;27219
FAC0030285;2015-05-22;CLI00493;FACTURA;45;2;105585;20061;125646
FAC0030286;2015-03-09;CLI00676;FACTURA;1;1;75864;14414;90278
FAC0030287;2015-05-09;CLI00168;FACTURA;6;1;50730;9639;60369
FAC0030288;2015-07-16;CLI00194;FACTURA;21;1;55418;10529;65947
FAC0030289;2015-09-23;CLI00678;FACTURA;26;1;10201;1938;12139
FAC0030290;2015-06-03;CLI00271;FACTURA;38;2;33828;6427;40255
FAC0030291;2015-05-14;CLI00277;FACTURA;33;2;162744;30921;193665
FAC0030292;2015-12-18;CLI00283;FACTURA;29;2;197344;37495;234839
FAC0030293;2015-09-20;CLI00734;FACTURA;48;1;9483;1802;11285
FAC0030294;2015-05-28;CLI00070;FACTURA;28;1;63568;12078;75646
FAC0030295;2015-07-03;CLI00907;FACTURA;21;2;43190;8206;51396
FAC0030296;2015-05-24;CLI00798;FACTURA;19;1;75588;14362;89950
FAC0030297;2015-05-12;CLI00157;FACTURA;25;2;137238;26075;163313
FAC0030298;2015-04-14;CLI00049;FACTURA;49;2;98452;18706;117158
FAC0030299;2015-03-18;CLI00547;FACTURA;3;2;159498;30305;189803
FAC0030300;2015-08-28;CLI00772;FACTURA;48;1;63291;12025;75316
FAC0030301;2015-10-05;CLI00093;FACTURA;44;2;239309;45469;284778
FAC0030302;2015-03-18;CLI00553;FACTURA;50;2;24716;4696;29412
FAC0030303;2015-10-03;CLI00509;FACTURA;25;2;199556;37916;237472
FAC0030304;2015-10-14;CLI00101;FACTURA;22;2;170073;32314;202387
FAC0030305;2015-02-22;CLI00536;FACTURA;41;1;86004;16341;102345
FAC0030306;2015-12-12;CLI00342;FACTURA;3;1;43253;8218;51471
FAC0030307;2015-01-16;CLI00982;FACTURA;45;1;63351;12037;75388
FAC0030308;2015-02-27;CLI00732;FACTURA;20;1;66122;12563;78685
FAC0030309;2015-10-20;CLI00288;FACTURA;46;1;33792;6420;40212
FAC0030310;2015-03-14;CLI00898;FACTURA;37;1;145224;27593;172817
FAC0030311;2015-12-24;CLI00857;FACTURA;34;2;98452;18706;117158
FAC0030312;2015-05-27;CLI00451;FACTURA;24;2;136542;25943;162485
FAC0030313;2015-10-21;CLI00672;FACTURA;10;1;63351;12037;75388
FAC0030314;2015-08-09;CLI00848;FACTURA;29;1;50742;9641;60383
FAC0030315;2015-06-13;CLI00761;FACTURA;15;2;20292;3855;24147
FAC0030316;2015-10-11;CLI00207;FACTURA;32;2;312390;59354;371744
FAC0030317;2015-12-29;CLI00512;FACTURA;47;1;34187;6496;40683
FAC0030318;2015-04-30;CLI00139;FACTURA;13;2;101532;19291;120823
FAC0030319;2015-09-21;CLI00362;FACTURA;45;1;196596;37353;233949
FAC0030320;2015-04-08;CLI00411;FACTURA;28;2;71514;13588;85102
FAC0030321;2015-05-09;CLI00087;FACTURA;34;2;24613;4676;29289
FAC0030322;2015-07-30;CLI00503;FACTURA;6;2;235179;44684;279863
FAC0030323;2015-01-19;CLI00321;FACTURA;23;2;68619;13038;81657
FAC0030324;2015-10-07;CLI00589;FACTURA;39;2;127365;24199;151564
FAC0030325;2015-12-24;CLI00610;FACTURA;23;1;28190;5356;33546
FAC0030326;2015-12-16;CLI00939;FACTURA;32;2;84388;16034;100422
FAC0030327;2015-02-17;CLI00120;FACTURA;28;1;43610;8286;51896
FAC0030328;2015-01-29;CLI00269;FACTURA;22;2;28668;5447;34115
FAC0030329;2015-11-04;CLI00597;FACTURA;43;2;151788;28840;180628
FAC0030330;2015-12-31;CLI00797;FACTURA;24;2;161360;30658;192018
FAC0030331;2015-12-23;CLI00099;FACTURA;46;2;42240;8026;50266
FAC0030332;2015-11-26;CLI00676;FACTURA;3;1;10201;1938;12139
FAC0030333;2015-01-13;CLI00114;FACTURA;50;1;96210;18280;114490
FAC0030334;2015-04-02;CLI00908;FACTURA;30;1;52908;10053;62961
FAC0030335;2015-04-02;CLI00609;FACTURA;6;2;75864;14414;90278
FAC0030336;2015-02-08;CLI00889;FACTURA;2;2;58518;11118;69636
FAC0030337;2015-05-25;CLI00507;FACTURA;32;2;114365;21729;136094
FAC0030338;2015-01-26;CLI00499;FACTURA;36;2;69420;13190;82610
FAC0030339;2015-12-05;CLI00356;FACTURA;8;1;254730;48399;303129
FAC0030340;2015-11-28;CLI00863;FACTURA;45;2;84480;16051;100531
FAC0030341;2015-05-18;CLI00089;FACTURA;22;2;22639;4301;26940
FAC0030342;2015-02-11;CLI00196;FACTURA;18;1;61790;11740;73530
FAC0030343;2015-01-11;CLI00490;FACTURA;47;1;246130;46765;292895
FAC0030344;2015-05-07;CLI00227;FACTURA;32;2;31437;5973;37410
FAC0030345;2015-09-09;CLI00631;FACTURA;23;2;63291;12025;75316
FAC0030346;2015-06-04;CLI00055;FACTURA;3;2;100791;19150;119941
FAC0030347;2015-11-22;CLI00707;FACTURA;20;2;81213;15430;96643
FAC0030348;2015-07-14;CLI00575;FACTURA;32;2;189497;36004;225501
FAC0030349;2015-01-24;CLI00172;FACTURA;16;1;203751;38713;242464
FAC0030350;2015-10-30;CLI00051;FACTURA;33;2;18892;3589;22481
FAC0030351;2015-05-19;CLI00125;FACTURA;49;2;168776;32067;200843
FAC0030352;2015-07-29;CLI00344;FACTURA;15;1;133236;25315;158551
FAC0030353;2015-02-02;CLI00676;FACTURA;42;1;171048;32499;203547
FAC0030354;2015-05-12;CLI00871;FACTURA;17;2;50596;9613;60209
FAC0030355;2015-10-24;CLI00655;FACTURA;28;2;100735;19140;119875
FAC0030356;2015-11-02;CLI00713;FACTURA;41;2;33828;6427;40255
FAC0030357;2015-03-24;CLI00851;FACTURA;25;2;76419;14520;90939
FAC0030358;2015-02-28;CLI00159;FACTURA;25;2;55418;10529;65947
FAC0030359;2015-02-01;CLI00402;FACTURA;24;1;208260;39569;247829
FAC0030360;2015-08-21;CLI00027;FACTURA;17;2;112245;21327;133572
FAC0030361;2015-12-14;CLI00410;FACTURA;21;1;190701;36233;226934
FAC0030362;2015-11-07;CLI00660;FACTURA;49;1;10201;1938;12139
FAC0030363;2015-02-03;CLI00983;FACTURA;12;2;217944;41409;259353
FAC0030364;2015-01-26;CLI00779;FACTURA;11;2;5638;1071;6709
FAC0030365;2015-04-10;CLI00789;FACTURA;8;2;32272;6132;38404
FAC0030366;2015-05-29;CLI00755;FACTURA;18;2;47415;9009;56424
FAC0030367;2015-04-08;CLI00196;FACTURA;43;1;218050;41430;259480
FAC0030368;2015-11-07;CLI00731;FACTURA;43;2;172676;32808;205484
FAC0030369;2015-03-21;CLI00902;FACTURA;20;1;140555;26705;167260
FAC0030370;2015-05-09;CLI00041;FACTURA;24;2;168666;32047;200713
FAC0030371;2015-10-10;CLI00545;FACTURA;36;2;22552;4285;26837
FAC0030372;2015-03-08;CLI00550;FACTURA;16;1;221517;42088;263605
FAC0030373;2015-07-07;CLI00845;FACTURA;48;2;63351;12037;75388
FAC0030374;2015-06-19;CLI00371;FACTURA;14;2;71502;13585;85087
FAC0030375;2015-10-13;CLI00681;FACTURA;39;2;193963;36853;230816
FAC0030376;2015-12-30;CLI00613;FACTURA;15;2;8448;1605;10053
FAC0030377;2015-07-02;CLI00698;FACTURA;21;1;6170;1172;7342
FAC0030378;2015-04-28;CLI00137;FACTURA;12;2;174018;33063;207081
FAC0030379;2015-05-18;CLI00074;FACTURA;31;1;97530;18531;116061
FAC0030380;2015-11-16;CLI00348;FACTURA;23;1;126490;24033;150523
FAC0030381;2015-06-27;CLI00442;FACTURA;44;1;123452;23456;146908
FAC0030382;2015-02-08;CLI00517;FACTURA;7;2;9483;1802;11285
FAC0030383;2015-03-03;CLI00803;FACTURA;26;2;153013;29072;182085
FAC0030384;2015-01-15;CLI00466;FACTURA;34;1;20402;3876;24278
FAC0030385;2015-01-04;CLI00030;FACTURA;43;1;203430;38652;242082
FAC0030386;2015-12-31;CLI00291;FACTURA;41;2;176360;33508;209868
FAC0030387;2015-11-05;CLI00963;FACTURA;19;2;221672;42118;263790
FAC0030388;2015-12-28;CLI00587;FACTURA;47;2;50730;9639;60369
FAC0030389;2015-11-14;CLI00671;FACTURA;23;2;112952;21461;134413
FAC0030390;2015-10-01;CLI00105;FACTURA;8;2;100735;19140;119875
FAC0030391;2015-12-30;CLI00414;FACTURA;49;1;27071;5143;32214
FAC0030392;2015-07-29;CLI00250;FACTURA;8;1;302373;57451;359824
FAC0030393;2015-12-31;CLI00733;FACTURA;38;2;192690;36611;229301
FAC0030394;2015-01-16;CLI00871;FACTURA;20;2;67584;12841;80425
FAC0030395;2015-06-26;CLI00455;FACTURA;29;2;217944;41409;259353
FAC0030396;2015-09-27;CLI00035;FACTURA;44;2;5638;1071;6709
FAC0030397;2015-09-05;CLI00614;FACTURA;5;1;76218;14481;90699
FAC0030398;2015-06-04;CLI00847;FACTURA;35;2;40584;7711;48295
FAC0030399;2015-04-18;CLI00207;FACTURA;11;2;28190;5356;33546
FAC0030400;2015-10-22;CLI00210;FACTURA;7;1;195060;37061;232121
FAC0030401;2015-03-11;CLI00912;FACTURA;2;1;52395;9955;62350
FAC0030402;2015-02-01;CLI00083;FACTURA;29;2;222060;42191;264251
FAC0030403;2015-06-17;CLI00364;FACTURA;5;1;30850;5862;36712
FAC0030404;2015-02-26;CLI00637;FACTURA;24;2;203751;38713;242464
FAC0030405;2015-06-02;CLI00451;FACTURA;20;2;76419;14520;90939
FAC0030406;2015-07-11;CLI00681;FACTURA;15;2;27071;5143;32214
FAC0030407;2015-06-08;CLI00259;FACTURA;27;2;112245;21327;133572
FAC0030408;2015-12-19;CLI00812;FACTURA;5;1;24716;4696;29412
FAC0030409;2015-12-16;CLI00107;FACTURA;13;2;189873;36076;225949
FAC0030410;2015-12-01;CLI00669;FACTURA;32;2;133236;25315;158551
FAC0030411;2015-01-31;CLI00678;FACTURA;10;1;70544;13403;83947
FAC0030412;2015-01-12;CLI00063;FACTURA;31;2;75588;14362;89950
FAC0030413;2015-03-07;CLI00453;FACTURA;47;2;138545;26324;164869
FAC0030414;2015-12-27;CLI00853;FACTURA;50;2;312390;59354;371744
FAC0030415;2015-02-22;CLI00417;FACTURA;34;2;71407;13567;84974
FAC0030416;2015-06-12;CLI00606;FACTURA;32;1;141029;26796;167825
FAC0030417;2015-12-08;CLI00398;FACTURA;16;1;228654;43444;272098
FAC0030418;2015-04-15;CLI00660;FACTURA;38;1;87220;16572;103792
FAC0030419;2015-10-28;CLI00881;FACTURA;14;2;131064;24902;155966
FAC0030420;2015-04-22;CLI00997;FACTURA;3;2;27348;5196;32544
FAC0030421;2015-04-14;CLI00544;FACTURA;19;1;208260;39569;247829
FAC0030422;2015-12-08;CLI00855;FACTURA;38;2;19506;3706;23212
FAC0030423;2015-07-16;CLI00548;FACTURA;36;1;41022;7794;48816
FAC0030424;2015-04-21;CLI00795;FACTURA;48;2;312390;59354;371744
FAC0030425;2015-08-09;CLI00877;FACTURA;14;2;30895;5870;36765
FAC0030426;2015-10-30;CLI00905;FACTURA;8;2;31784;6039;37823
FAC0030427;2015-11-05;CLI00694;FACTURA;12;1;108284;20574;128858
FAC0030428;2015-07-21;CLI00007;FACTURA;26;2;195060;37061;232121
FAC0030429;2015-09-12;CLI00356;FACTURA;27;1;53166;10102;63268
FAC0030430;2015-12-30;CLI00391;FACTURA;12;2;307683;58460;366143
FAC0030431;2015-03-17;CLI00409;FACTURA;27;2;307683;58460;366143
FAC0030432;2015-01-06;CLI00619;FACTURA;31;2;71670;13617;85287
FAC0030433;2015-06-16;CLI00386;FACTURA;34;1;42240;8026;50266
FAC0030434;2015-04-08;CLI00360;FACTURA;23;1;32272;6132;38404
FAC0030435;2015-04-13;CLI00475;FACTURA;36;2;228654;43444;272098
FAC0030436;2015-12-19;CLI00609;FACTURA;6;2;243639;46291;289930
FAC0030437;2015-09-22;CLI00567;FACTURA;11;2;159498;30305;189803
FAC0030438;2015-02-21;CLI00811;FACTURA;12;2;56691;10771;67462
FAC0030439;2015-12-12;CLI00276;FACTURA;31;1;177086;33646;210732
FAC0030440;2015-03-06;CLI00436;FACTURA;32;1;19506;3706;23212
FAC0030441;2015-03-27;CLI00098;FACTURA;7;1;41022;7794;48816
FAC0030442;2015-03-10;CLI00836;FACTURA;43;1;195060;37061;232121
FAC0030443;2015-05-05;CLI00600;FACTURA;27;1;160350;30467;190817
FAC0030444;2015-02-08;CLI00977;FACTURA;5;2;104790;19910;124700
FAC0030445;2015-07-31;CLI00814;FACTURA;4;1;90556;17206;107762
FAC0030446;2015-07-29;CLI00948;FACTURA;24;1;153013;29072;182085
FAC0030447;2015-10-10;CLI00111;FACTURA;41;2;79749;15152;94901
FAC0030448;2015-11-22;CLI00460;FACTURA;48;1;43610;8286;51896
FAC0030449;2015-07-14;CLI00301;FACTURA;9;2;136215;25881;162096
FAC0030450;2015-02-21;CLI00588;FACTURA;6;1;91492;17383;108875
FAC0030451;2015-08-14;CLI00087;FACTURA;44;2;178311;33879;212190
FAC0030452;2015-09-21;CLI00082;FACTURA;9;1;235179;44684;279863
FAC0030453;2015-01-26;CLI00966;FACTURA;28;1;101892;19359;121251
FAC0030454;2015-02-05;CLI00021;FACTURA;14;2;189497;36004;225501
FAC0030455;2015-07-30;CLI00991;FACTURA;11;2;133236;25315;158551
FAC0030456;2015-12-02;CLI00050;FACTURA;29;1;168666;32047;200713
FAC0030457;2015-05-26;CLI00977;FACTURA;26;2;59585;11321;70906
FAC0030458;2015-11-18;CLI00238;FACTURA;48;1;265830;50508;316338
FAC0030459;2015-09-21;CLI00267;FACTURA;17;2;28338;5384;33722
FAC0030460;2015-08-12;CLI00698;FACTURA;43;1;189497;36004;225501
FAC0030461;2015-04-13;CLI00891;FACTURA;37;2;193963;36853;230816
FAC0030462;2015-07-17;CLI00528;FACTURA;3;1;51005;9691;60696
FAC0030463;2015-03-04;CLI00259;FACTURA;50;2;243628;46289;289917
FAC0030464;2015-03-22;CLI00507;FACTURA;15;2;49432;9392;58824
FAC0030465;2015-09-27;CLI00305;FACTURA;50;2;28190;5356;33546
FAC0030466;2015-12-23;CLI00183;FACTURA;23;2;239247;45457;284704
FAC0030467;2015-03-19;CLI00330;FACTURA;24;1;37784;7179;44963
FAC0030468;2015-01-25;CLI00343;FACTURA;25;2;28668;5447;34115
FAC0030469;2015-12-15;CLI00106;FACTURA;12;1;20147;3828;23975
FAC0030470;2015-09-08;CLI00893;FACTURA;29;2;140555;26705;167260
FAC0030471;2015-03-29;CLI00247;FACTURA;45;2;29003;5511;34514
FAC0030472;2015-10-18;CLI00053;FACTURA;9;2;168936;32098;201034
FAC0030473;2015-05-23;CLI00006;FACTURA;18;1;57016;10833;67849
FAC0030474;2015-05-06;CLI00381;FACTURA;50;2;151788;28840;180628
FAC0030475;2015-12-31;CLI00299;FACTURA;17;2;87436;16613;104049
FAC0030476;2015-07-24;CLI00665;FACTURA;4;2;21805;4143;25948
FAC0030477;2015-09-28;CLI00938;FACTURA;18;1;224888;42729;267617
FAC0030478;2015-12-17;CLI00024;FACTURA;49;1;86004;16341;102345
FAC0030479;2015-08-06;CLI00618;FACTURA;44;1;239247;45457;284704
FAC0030480;2015-03-27;CLI00623;FACTURA;29;2;135355;25717;161072
FAC0030481;2015-04-16;CLI00638;FACTURA;1;1;136542;25943;162485
FAC0030482;2015-06-18;CLI00648;FACTURA;42;1;68724;13058;81782
FAC0030483;2015-04-08;CLI00959;FACTURA;16;2;20292;3855;24147
FAC0030484;2015-04-26;CLI00283;FACTURA;18;2;57016;10833;67849
FAC0030485;2015-06-28;CLI00080;FACTURA;40;1;37794;7181;44975
FAC0030486;2015-06-07;CLI00325;FACTURA;50;2;62874;11946;74820
FAC0030487;2015-02-03;CLI00275;FACTURA;28;2;37074;7044;44118
FAC0030488;2015-05-08;CLI00396;FACTURA;21;1;177842;33790;211632
FAC0030489;2015-09-17;CLI00750;FACTURA;46;1;59585;11321;70906
FAC0030490;2015-12-17;CLI00450;FACTURA;46;1;24668;4687;29355
FAC0030491;2015-06-10;CLI00184;FACTURA;40;1;158473;30110;188583
FAC0030492;2015-07-05;CLI00687;FACTURA;15;2;167985;31917;199902
FAC0030493;2015-04-20;CLI00492;FACTURA;8;1;68370;12990;81360
FAC0030494;2015-02-21;CLI00779;FACTURA;2;2;147819;28086;175905
FAC0030495;2015-10-24;CLI00364;FACTURA;40;1;30438;5783;36221
FAC0030496;2015-11-13;CLI00010;FACTURA;21;1;21859;4153;26012
FAC0030497;2015-07-25;CLI00302;FACTURA;24;1;74004;14061;88065
FAC0030498;2015-11-08;CLI00858;FACTURA;32;1;73839;14029;87868
FAC0030499;2015-06-11;CLI00617;FACTURA;4;2;129006;24511;153517
FAC0030500;2015-01-12;CLI00378;FACTURA;2;1;50730;9639;60369
FAC0030501;2015-07-05;CLI00781;FACTURA;33;2;195060;37061;232121
FAC0030502;2015-04-24;CLI00846;FACTURA;33;1;256572;48749;305321
FAC0030503;2015-07-04;CLI00904;FACTURA;42;1;272430;51762;324192
FAC0030504;2015-12-27;CLI00569;FACTURA;31;2;10479;1991;12470
FAC0030505;2015-02-06;CLI00342;FACTURA;25;1;5638;1071;6709
FAC0030506;2015-07-01;CLI00180;FACTURA;45;1;37784;7179;44963
FAC0030507;2015-01-08;CLI00671;FACTURA;12;2;83419;15850;99269
FAC0030508;2015-08-29;CLI00674;FACTURA;28;1;85640;16272;101912
FAC0030509;2015-09-07;CLI00601;FACTURA;28;2;55611;10566;66177
FAC0030510;2015-05-22;CLI00452;FACTURA;49;1;28449;5405;33854
FAC0030511;2015-08-02;CLI00124;FACTURA;18;1;112444;21364;133808
FAC0030512;2015-07-23;CLI00809;FACTURA;7;2;39466;7499;46965
FAC0030513;2015-07-04;CLI00936;FACTURA;8;1;228654;43444;272098
FAC0030514;2015-07-19;CLI00483;FACTURA;12;2;118454;22506;140960
FAC0030515;2015-04-12;CLI00371;FACTURA;46;2;76218;14481;90699
FAC0030516;2015-06-22;CLI00853;FACTURA;17;2;84480;16051;100531
FAC0030517;2015-11-19;CLI00425;FACTURA;14;2;6179;1174;7353
FAC0030518;2015-04-12;CLI00423;FACTURA;42;2;24716;4696;29412
FAC0030519;2015-09-19;CLI00521;FACTURA;40;2;108972;20705;129677
FAC0030520;2015-06-15;CLI00982;FACTURA;22;1;111030;21096;132126
FAC0030521;2015-01-08;CLI00725;FACTURA;37;2;169220;32152;201372
FAC0030522;2015-06-15;CLI00591;FACTURA;8;2;235179;44684;279863
FAC0030523;2015-12-26;CLI00460;FACTURA;10;1;6170;1172;7342
FAC0030524;2015-01-28;CLI00774;FACTURA;1;1;109392;20784;130176
FAC0030525;2015-11-05;CLI00661;FACTURA;36;2;31437;5973;37410
FAC0030526;2015-01-12;CLI00702;FACTURA;50;1;30438;5783;36221
FAC0030527;2015-09-16;CLI00856;FACTURA;44;1;196904;37412;234316
FAC0030528;2015-08-29;CLI00441;FACTURA;7;2;170935;32478;203413
FAC0030529;2015-03-18;CLI00909;FACTURA;23;2;101460;19277;120737
FAC0030530;2015-01-08;CLI00632;FACTURA;36;1;43002;8170;51172
FAC0030531;2015-01-22;CLI00017;FACTURA;36;2;41022;7794;48816
FAC0030532;2015-01-14;CLI00178;FACTURA;17;1;11454;2176;13630
FAC0030533;2015-09-04;CLI00911;FACTURA;45;2;71407;13567;84974
FAC0030534;2015-12-07;CLI00178;FACTURA;43;1;171280;32543;203823
FAC0030535;2015-03-23;CLI00766;FACTURA;19;1;69608;13226;82834
FAC0030536;2015-08-24;CLI00345;FACTURA;10;2;149870;28475;178345
FAC0030537;2015-04-09;CLI00626;FACTURA;37;1;212664;40406;253070
FAC0030538;2015-05-11;CLI00588;FACTURA;9;1;33828;6427;40255
FAC0030539;2015-12-23;CLI00209;FACTURA;1;2;58518;11118;69636
FAC0030540;2015-05-15;CLI00958;FACTURA;25;1;183087;34787;217874
FAC0030541;2015-07-12;CLI00796;FACTURA;29;1;18892;3589;22481
FAC0030542;2015-02-12;CLI00744;FACTURA;36;1;217944;41409;259353
FAC0030543;2015-09-09;CLI00193;FACTURA;12;2;139216;26451;165667
FAC0030544;2015-05-23;CLI00496;FACTURA;11;1;82044;15588;97632
FAC0030545;2015-07-14;CLI00241;FACTURA;46;2;18897;3590;22487
FAC0030546;2015-03-27;CLI00017;FACTURA;49;2;152838;29039;181877
FAC0030547;2015-08-26;CLI00565;FACTURA;16;2;203248;38617;241865
FAC0030548;2015-05-13;CLI00500;FACTURA;12;1;176360;33508;209868
FAC0030549;2015-02-23;CLI00358;FACTURA;13;1;168776;32067;200843
FAC0030550;2015-10-05;CLI00847;FACTURA;50;2;136215;25881;162096
FAC0030551;2015-05-21;CLI00365;FACTURA;18;2;49226;9353;58579
FAC0030552;2015-05-09;CLI00242;FACTURA;12;1;73839;14029;87868
FAC0030553;2015-04-09;CLI00570;FACTURA;31;1;85347;16216;101563
FAC0030554;2015-12-17;CLI00654;FACTURA;6;1;208824;39677;248501
FAC0030555;2015-08-11;CLI00584;FACTURA;31;1;203021;38574;241595
FAC0030556;2015-02-16;CLI00519;FACTURA;13;2;23834;4528;28362
FAC0030557;2015-08-21;CLI00447;FACTURA;3;2;88824;16877;105701
FAC0030558;2015-03-16;CLI00890;FACTURA;15;1;6170;1172;7342
FAC0030559;2015-11-08;CLI00626;FACTURA;2;1;50730;9639;60369
FAC0030560;2015-11-23;CLI00748;FACTURA;41;1;66618;12657;79275
FAC0030561;2015-09-04;CLI00864;FACTURA;44;1;16914;3214;20128
FAC0030562;2015-11-18;CLI00837;FACTURA;19;2;14334;2723;17057
FAC0030563;2015-04-26;CLI00405;FACTURA;6;2;50730;9639;60369
FAC0030564;2015-07-10;CLI00498;FACTURA;2;1;130830;24858;155688
FAC0030565;2015-03-30;CLI00760;FACTURA;26;1;32272;6132;38404
FAC0030566;2015-08-21;CLI00292;FACTURA;33;1;177086;33646;210732
FAC0030567;2015-08-12;CLI00052;FACTURA;10;1;226390;43014;269404
FAC0030568;2015-07-19;CLI00544;FACTURA;50;1;88824;16877;105701
FAC0030569;2015-09-11;CLI00147;FACTURA;12;2;16922;3215;20137
FAC0030570;2015-07-05;CLI00524;FACTURA;32;1;22639;4301;26940
FAC0030571;2015-10-07;CLI00410;FACTURA;42;1;186081;35355;221436
FAC0030572;2015-03-12;CLI00809;FACTURA;42;2;222060;42191;264251
FAC0030573;2015-02-08;CLI00701;FACTURA;5;2;21805;4143;25948
FAC0030574;2015-06-02;CLI00249;FACTURA;2;2;62874;11946;74820
FAC0030575;2015-05-30;CLI00357;FACTURA;46;2;30603;5815;36418
FAC0030576;2015-12-17;CLI00242;FACTURA;6;1;81213;15430;96643
FAC0030577;2015-06-26;CLI00354;FACTURA;14;1;50766;9646;60412
FAC0030578;2015-02-10;CLI00313;FACTURA;21;2;261027;49595;310622
FAC0030579;2015-07-01;CLI00180;FACTURA;11;1;51005;9691;60696
FAC0030580;2015-03-09;CLI00495;FACTURA;3;2;43190;8206;51396
FAC0030581;2015-02-02;CLI00336;FACTURA;17;1;182984;34767;217751
FAC0030582;2015-03-10;CLI00764;FACTURA;45;1;155442;29534;184976
FAC0030583;2015-08-18;CLI00603;FACTURA;45;2;174440;33144;207584
FAC0030584;2015-03-23;CLI00095;FACTURA;27;2;40294;7656;47950
FAC0030585;2015-10-14;CLI00387;FACTURA;20;2;178311;33879;212190
FAC0030586;2015-01-10;CLI00192;FACTURA;7;1;196731;37379;234110
FAC0030587;2015-01-25;CLI00082;FACTURA;32;1;168936;32098;201034
FAC0030588;2015-04-11;CLI00319;FACTURA;7;2;50742;9641;60383
FAC0030589;2015-07-11;CLI00500;FACTURA;28;1;105485;20042;125527
FAC0030590;2015-01-10;CLI00264;FACTURA;12;1;80588;15312;95900
FAC0030591;2015-12-05;CLI00559;FACTURA;12;2;114032;21666;135698
FAC0030592;2015-02-24;CLI00178;FACTURA;26;1;28668;5447;34115
FAC0030593;2015-10-19;CLI00568;FACTURA;22;1;101624;19309;120933
FAC0030594;2015-01-22;CLI00885;FACTURA;23;2;246680;46869;293549
FAC0030595;2015-08-10;CLI00908;FACTURA;44;1;246680;46869;293549
FAC0030596;2015-08-22;CLI00992;FACTURA;6;1;75588;14362;89950
FAC0030597;2015-05-04;CLI00666;FACTURA;47;1;75588;14362;89950
FAC0030598;2015-09-18;CLI00210;FACTURA;15;1;94311;17919;112230
FAC0030599;2015-10-04;CLI00162;FACTURA;38;1;28668;5447;34115
FAC0030600;2015-06-12;CLI00397;FACTURA;27;2;129006;24511;153517
FAC0030601;2015-11-19;CLI00490;FACTURA;5;1;45816;8705;54521
FAC0030602;2015-02-06;CLI00633;FACTURA;11;2;47668;9057;56725
FAC0030603;2015-07-22;CLI00186;FACTURA;48;1;21410;4068;25478
FAC0030604;2015-12-10;CLI00491;FACTURA;50;2;56676;10768;67444
FAC0030605;2015-04-17;CLI00399;FACTURA;31;2;123340;23435;146775
FAC0030606;2015-10-30;CLI00706;FACTURA;46;1;61790;11740;73530
FAC0030607;2015-10-05;CLI00213;FACTURA;13;2;37020;7034;44054
FAC0030608;2015-07-06;CLI00783;FACTURA;3;2;229257;43559;272816
FAC0030609;2015-12-30;CLI00822;FACTURA;21;1;80175;15233;95408
FAC0030610;2015-07-31;CLI00809;FACTURA;18;2;41916;7964;49880
FAC0030611;2015-02-18;CLI00654;FACTURA;1;1;87220;16572;103792
FAC0030612;2015-05-23;CLI00608;FACTURA;28;1;94485;17952;112437
FAC0030613;2015-07-22;CLI00615;FACTURA;22;2;68619;13038;81657
FAC0030614;2015-12-24;CLI00832;FACTURA;32;1;199556;37916;237472
FAC0030615;2015-11-24;CLI00688;FACTURA;43;1;197344;37495;234839
FAC0030616;2015-03-05;CLI00447;FACTURA;4;2;239247;45457;284704
FAC0030617;2015-05-27;CLI00193;FACTURA;50;2;65577;12460;78037
FAC0030618;2015-06-12;CLI00223;FACTURA;20;2;42194;8017;50211
FAC0030619;2015-01-17;CLI00110;FACTURA;24;1;71670;13617;85287
FAC0030620;2015-04-12;CLI00193;FACTURA;15;2;18966;3604;22570
FAC0030621;2015-12-02;CLI00661;FACTURA;21;2;127365;24199;151564
FAC0030622;2015-01-02;CLI00532;FACTURA;47;1;28190;5356;33546
FAC0030623;2015-03-10;CLI00128;FACTURA;36;1;49432;9392;58824
FAC0030624;2015-02-21;CLI00043;FACTURA;45;2;129006;24511;153517
FAC0030625;2015-12-12;CLI00095;FACTURA;1;2;278432;52902;331334
FAC0030626;2015-10-09;CLI00482;FACTURA;5;1;137238;26075;163313
FAC0030627;2015-01-16;CLI00575;FACTURA;11;2;159498;30305;189803
FAC0030628;2015-10-04;CLI00554;FACTURA;4;1;85640;16272;101912
FAC0030629;2015-06-22;CLI00598;FACTURA;10;1;37794;7181;44975
FAC0030630;2015-09-09;CLI00942;FACTURA;4;1;203021;38574;241595
FAC0030631;2015-10-22;CLI00318;FACTURA;10;1;37794;7181;44975
FAC0030632;2015-10-28;CLI00997;FACTURA;20;2;20958;3982;24940
FAC0030633;2015-04-03;CLI00921;FACTURA;42;2;190053;36110;226163
FAC0030634;2015-04-28;CLI00909;FACTURA;19;2;117036;22237;139273
FAC0030635;2015-12-19;CLI00359;FACTURA;49;2;246680;46869;293549
FAC0030636;2015-11-08;CLI00159;FACTURA;4;2;136740;25981;162721
FAC0030637;2015-12-17;CLI00177;FACTURA;47;2;123065;23382;146447
FAC0030638;2015-04-14;CLI00207;FACTURA;38;2;172676;32808;205484
FAC0030639;2015-07-20;CLI00255;FACTURA;40;2;111030;21096;132126
FAC0030640;2015-09-06;CLI00980;FACTURA;45;1;94830;18018;112848
FAC0030641;2015-05-30;CLI00832;FACTURA;3;1;177842;33790;211632
FAC0030642;2015-02-17;CLI00711;FACTURA;34;2;201582;38301;239883
FAC0030643;2015-04-27;CLI00758;FACTURA;1;1;136542;25943;162485
FAC0030644;2015-01-14;CLI00433;FACTURA;18;2;47668;9057;56725
FAC0030645;2015-08-25;CLI00543;FACTURA;22;2;170073;32314;202387
FAC0030646;2015-03-16;CLI00458;FACTURA;19;1;19506;3706;23212
FAC0030647;2015-10-31;CLI00998;FACTURA;38;1;181112;34411;215523
FAC0030648;2015-12-19;CLI00323;FACTURA;40;2;18510;3517;22027
FAC0030649;2015-05-20;CLI00522;FACTURA;11;1;49432;9392;58824
FAC0030650;2015-10-01;CLI00108;FACTURA;32;1;21805;4143;25948
FAC0030651;2015-03-16;CLI00564;FACTURA;9;1;61029;11596;72625
FAC0030652;2015-09-07;CLI00703;FACTURA;48;2;169220;32152;201372
FAC0030653;2015-04-26;CLI00478;FACTURA;22;1;18892;3589;22481
FAC0030654;2015-01-27;CLI00197;FACTURA;24;2;192690;36611;229301
FAC0030655;2015-08-24;CLI00975;FACTURA;30;2;128280;24373;152653
FAC0030656;2015-11-07;CLI00744;FACTURA;9;1;163458;31057;194515
FAC0030657;2015-02-19;CLI00110;FACTURA;50;1;61790;11740;73530
FAC0030658;2015-06-26;CLI00127;FACTURA;10;2;37074;7044;44118
FAC0030659;2015-11-04;CLI00032;FACTURA;24;1;10201;1938;12139
FAC0030660;2015-08-12;CLI00999;FACTURA;30;2;16035;3047;19082
FAC0030661;2015-11-06;CLI00590;FACTURA;21;1;84468;16049;100517
FAC0030662;2015-02-18;CLI00951;FACTURA;3;2;48408;9198;57606
FAC0030663;2015-05-04;CLI00370;FACTURA;14;1;170935;32478;203413
FAC0030664;2015-09-25;CLI00027;FACTURA;2;2;56691;10771;67462
FAC0030665;2015-08-05;CLI00246;FACTURA;6;1;84480;16051;100531
FAC0030666;2015-04-07;CLI00346;FACTURA;16;1;141029;26796;167825
FAC0030667;2015-12-12;CLI00873;FACTURA;35;2;59136;11236;70372
FAC0030668;2015-04-26;CLI00370;FACTURA;31;1;61700;11723;73423
FAC0030669;2015-06-08;CLI00297;FACTURA;30;2;142540;27083;169623
FAC0030670;2015-08-09;CLI00254;FACTURA;38;1;152838;29039;181877
FAC0030671;2015-07-30;CLI00895;FACTURA;9;2;51005;9691;60696
FAC0030672;2015-12-14;CLI00152;FACTURA;49;1;196731;37379;234110
FAC0030673;2015-11-09;CLI00777;FACTURA;25;2;18892;3589;22481
FAC0030674;2015-06-18;CLI00587;FACTURA;5;2;348040;66128;414168
FAC0030675;2015-03-31;CLI00182;FACTURA;40;1;112444;21364;133808
FAC0030676;2015-10-28;CLI00906;FACTURA;22;1;201470;38279;239749
FAC0030677;2015-10-08;CLI00266;FACTURA;26;1;113195;21507;134702
FAC0030678;2015-03-08;CLI00143;FACTURA;36;2;55611;10566;66177
FAC0030679;2015-10-14;CLI00660;FACTURA;31;1;51005;9691;60696
FAC0030680;2015-11-17;CLI00964;FACTURA;11;1;50946;9680;60626
FAC0030681;2015-05-21;CLI00228;FACTURA;28;1;23834;4528;28362
FAC0030682;2015-02-14;CLI00719;FACTURA;36;2;229257;43559;272816
FAC0030683;2015-02-09;CLI00689;FACTURA;15;2;18966;3604;22570
FAC0030684;2015-02-16;CLI00267;FACTURA;31;2;307683;58460;366143
FAC0030685;2015-05-13;CLI00365;FACTURA;48;2;243628;46289;289917
FAC0030686;2015-05-06;CLI00902;FACTURA;21;1;81608;15506;97114
FAC0030687;2015-10-25;CLI00231;FACTURA;8;2;37784;7179;44963
FAC0030688;2015-06-20;CLI00390;FACTURA;24;1;85347;16216;101563
FAC0030689;2015-06-30;CLI00920;FACTURA;34;1;49336;9374;58710
FAC0030690;2015-03-22;CLI00346;FACTURA;21;1;153013;29072;182085
FAC0030691;2015-07-20;CLI00083;FACTURA;34;2;19506;3706;23212
FAC0030692;2015-01-11;CLI00766;FACTURA;26;1;203784;38719;242503
FAC0030693;2015-04-19;CLI00660;FACTURA;31;1;262128;49804;311932
FAC0030694;2015-12-05;CLI00161;FACTURA;21;2;21117;4012;25129
FAC0030695;2015-03-30;CLI00964;FACTURA;31;1;59136;11236;70372
FAC0030696;2015-10-20;CLI00817;FACTURA;49;2;171048;32499;203547
FAC0030697;2015-11-21;CLI00402;FACTURA;34;1;12340;2345;14685
FAC0030698;2015-10-17;CLI00063;FACTURA;27;2;56676;10768;67444
FAC0030699;2015-04-15;CLI00629;FACTURA;49;2;12358;2348;14706
FAC0030700;2015-03-20;CLI00588;FACTURA;48;1;140555;26705;167260
FAC0030701;2015-06-02;CLI00558;FACTURA;27;1;47676;9058;56734
FAC0030702;2015-11-14;CLI00765;FACTURA;31;2;128280;24373;152653
FAC0030703;2015-07-06;CLI00906;FACTURA;49;1;341870;64955;406825
FAC0030704;2015-11-12;CLI00732;FACTURA;33;1;261027;49595;310622
FAC0030705;2015-09-12;CLI00810;FACTURA;37;1;162744;30921;193665
FAC0030706;2015-04-17;CLI00804;FACTURA;8;1;105485;20042;125527
FAC0030707;2015-07-05;CLI00560;FACTURA;7;1;113382;21543;134925
FAC0030708;2015-08-06;CLI00501;FACTURA;40;2;75894;14420;90314
FAC0030709;2015-09-11;CLI00472;FACTURA;45;1;196904;37412;234316
FAC0030710;2015-02-15;CLI00700;FACTURA;47;1;261027;49595;310622
FAC0030711;2015-11-01;CLI00117;FACTURA;4;2;42194;8017;50211
FAC0030712;2015-05-21;CLI00954;FACTURA;4;1;18966;3604;22570
FAC0030713;2015-03-23;CLI00522;FACTURA;14;1;178311;33879;212190
FAC0030714;2015-10-21;CLI00849;FACTURA;30;2;112444;21364;133808
FAC0030715;2015-10-11;CLI00287;FACTURA;8;2;69608;13226;82834
FAC0030716;2015-11-25;CLI00491;FACTURA;28;2;177648;33753;211401
FAC0030717;2015-02-26;CLI00977;FACTURA;14;2;44412;8438;52850
FAC0030718;2015-06-15;CLI00340;FACTURA;47;1;123340;23435;146775
FAC0030719;2015-09-28;CLI00536;FACTURA;44;1;109392;20784;130176
FAC0030720;2015-04-24;CLI00158;FACTURA;18;1;32070;6093;38163
FAC0030721;2015-12-22;CLI00012;FACTURA;28;1;24613;4676;29289
FAC0030722;2015-05-15;CLI00701;FACTURA;39;2;32272;6132;38404
FAC0030723;2015-04-10;CLI00728;FACTURA;8;1;27071;5143;32214
FAC0030724;2015-09-01;CLI00886;FACTURA;32;1;73839;14029;87868
FAC0030725;2015-06-29;CLI00291;FACTURA;24;2;130830;24858;155688
FAC0030726;2015-10-18;CLI00526;FACTURA;13;1;126582;24051;150633
FAC0030727;2015-05-23;CLI00535;FACTURA;27;2;86004;16341;102345
FAC0030728;2015-07-11;CLI00667;FACTURA;17;2;196596;37353;233949
FAC0030729;2015-04-25;CLI00920;FACTURA;13;1;39012;7412;46424
FAC0030730;2015-08-18;CLI00644;FACTURA;39;1;55530;10551;66081
FAC0030731;2015-11-13;CLI00748;FACTURA;20;1;174872;33226;208098
FAC0030732;2015-01-08;CLI00212;FACTURA;23;1;66381;12612;78993
FAC0030733;2015-01-09;CLI00951;FACTURA;34;2;126582;24051;150633
FAC0030734;2015-06-02;CLI00301;FACTURA;20;2;31784;6039;37823
FAC0030735;2015-11-27;CLI00370;FACTURA;8;1;80680;15329;96009
FAC0030736;2015-06-09;CLI00275;FACTURA;10;2;228730;43459;272189
FAC0030737;2015-11-21;CLI00514;FACTURA;25;1;16035;3047;19082
FAC0030738;2015-03-10;CLI00194;FACTURA;39;1;29003;5511;34514
FAC0030739;2015-08-24;CLI00150;FACTURA;16;1;27243;5176;32419
FAC0030740;2015-05-24;CLI00268;FACTURA;32;1;49432;9392;58824
FAC0030741;2015-03-14;CLI00557;FACTURA;19;2;67194;12767;79961
FAC0030742;2015-02-25;CLI00098;FACTURA;16;1;37932;7207;45139
FAC0030743;2015-07-07;CLI00220;FACTURA;39;1;273496;51964;325460
FAC0030744;2015-05-18;CLI00618;FACTURA;45;1;41022;7794;48816
FAC0030745;2015-05-21;CLI00288;FACTURA;24;1;20292;3855;24147
FAC0030746;2015-07-29;CLI00209;FACTURA;40;2;29003;5511;34514
FAC0030747;2015-09-17;CLI00535;FACTURA;12;2;85640;16272;101912
FAC0030748;2015-02-03;CLI00289;FACTURA;8;2;51005;9691;60696
FAC0030749;2015-04-13;CLI00479;FACTURA;13;2;254730;48399;303129
FAC0030750;2015-10-19;CLI00164;FACTURA;37;1;87436;16613;104049
FAC0030751;2015-11-25;CLI00363;FACTURA;26;2;147819;28086;175905
FAC0030752;2015-05-01;CLI00438;FACTURA;5;1;34187;6496;40683
FAC0030753;2015-06-07;CLI00726;FACTURA;10;1;107253;20378;127631
FAC0030754;2015-12-14;CLI00415;FACTURA;46;2;23838;4529;28367
FAC0030755;2015-11-09;CLI00464;FACTURA;5;1;96816;18395;115211
FAC0030756;2015-03-15;CLI00439;FACTURA;25;2;33597;6383;39980
FAC0030757;2015-07-26;CLI00814;FACTURA;18;1;170935;32478;203413
FAC0030758;2015-05-19;CLI00272;FACTURA;10;1;132915;25254;158169
FAC0030759;2015-02-15;CLI00966;FACTURA;9;1;67194;12767;79961
FAC0030760;2015-12-20;CLI00388;FACTURA;2;1;18510;3517;22027
FAC0030761;2015-01-10;CLI00012;FACTURA;16;1;65415;12429;77844
FAC0030762;2015-07-05;CLI00186;FACTURA;38;1;243639;46291;289930
FAC0030763;2015-09-25;CLI00642;FACTURA;6;1;28508;5417;33925
FAC0030764;2015-01-19;CLI00560;FACTURA;35;1;114672;21788;136460
FAC0030765;2015-06-12;CLI00841;FACTURA;38;2;47230;8974;56204
FAC0030766;2015-12-28;CLI00265;FACTURA;27;2;5638;1071;6709
FAC0030767;2015-12-29;CLI00845;FACTURA;14;2;43002;8170;51172
FAC0030768;2015-08-04;CLI00784;FACTURA;34;1;162744;30921;193665
FAC0030769;2015-05-31;CLI00106;FACTURA;47;1;30603;5815;36418
FAC0030770;2015-01-05;CLI00617;FACTURA;9;2;109392;20784;130176
FAC0030771;2015-07-16;CLI00914;FACTURA;25;1;50946;9680;60626
FAC0030772;2015-03-29;CLI00736;FACTURA;25;1;96210;18280;114490
FAC0030773;2015-04-22;CLI00111;FACTURA;48;2;47415;9009;56424
FAC0030774;2015-10-02;CLI00441;FACTURA;19;2;135834;25808;161642
FAC0030775;2015-01-10;CLI00354;FACTURA;14;1;20292;3855;24147
FAC0030776;2015-10-18;CLI00284;FACTURA;31;1;82044;15588;97632
FAC0030777;2015-12-06;CLI00383;FACTURA;48;2;151176;28723;179899
FAC0030778;2015-07-06;CLI00005;FACTURA;28;2;162744;30921;193665
FAC0030779;2015-03-19;CLI00896;FACTURA;4;1;101624;19309;120933
FAC0030780;2015-01-05;CLI00387;FACTURA;6;2;81608;15506;97114
FAC0030781;2015-07-02;CLI00837;FACTURA;9;2;70544;13403;83947
FAC0030782;2015-04-15;CLI00589;FACTURA;21;2;16896;3210;20106
FAC0030783;2015-01-10;CLI00514;FACTURA;8;1;98672;18748;117420
FAC0030784;2015-08-07;CLI00189;FACTURA;43;2;239309;45469;284778
FAC0030785;2015-04-19;CLI00218;FACTURA;7;1;50812;9654;60466
FAC0030786;2015-01-13;CLI00885;FACTURA;19;2;54696;10392;65088
FAC0030787;2015-01-05;CLI00169;FACTURA;35;2;43253;8218;51471
FAC0030788;2015-02-18;CLI00137;FACTURA;35;2;177842;33790;211632
FAC0030789;2015-07-25;CLI00375;FACTURA;40;2;57270;10881;68151
FAC0030790;2015-08-28;CLI00055;FACTURA;42;2;91492;17383;108875
FAC0030791;2015-01-06;CLI00060;FACTURA;34;1;104412;19838;124250
FAC0030792;2015-05-22;CLI00282;FACTURA;5;1;168666;32047;200713
FAC0030793;2015-03-28;CLI00409;FACTURA;42;2;195060;37061;232121
FAC0030794;2015-08-18;CLI00846;FACTURA;26;1;76419;14520;90939
FAC0030795;2015-03-14;CLI00593;FACTURA;48;2;50766;9646;60412
FAC0030796;2015-01-16;CLI00690;FACTURA;45;1;155442;29534;184976
FAC0030797;2015-11-08;CLI00676;FACTURA;41;1;205122;38973;244095
FAC0030798;2015-06-21;CLI00184;FACTURA;35;1;168666;32047;200713
FAC0030799;2015-04-03;CLI00727;FACTURA;30;2;10146;1928;12074
FAC0030800;2015-01-02;CLI00433;FACTURA;27;2;143340;27235;170575
FAC0030801;2015-01-27;CLI00202;FACTURA;27;1;100791;19150;119941
FAC0030802;2015-05-09;CLI00209;FACTURA;45;2;126490;24033;150523
FAC0030803;2015-05-29;CLI00889;FACTURA;16;2;48408;9198;57606
FAC0030804;2015-09-06;CLI00382;FACTURA;26;1;19506;3706;23212
FAC0030805;2015-10-07;CLI00795;FACTURA;25;2;43002;8170;51172
FAC0030806;2015-11-15;CLI00601;FACTURA;31;2;23834;4528;28362
FAC0030807;2015-08-07;CLI00422;FACTURA;26;1;168666;32047;200713
FAC0030808;2015-12-31;CLI00547;FACTURA;46;2;60441;11484;71925
FAC0030809;2015-11-12;CLI00564;FACTURA;49;1;30603;5815;36418
FAC0030810;2015-07-14;CLI00282;FACTURA;12;1;56222;10682;66904
FAC0030811;2015-07-27;CLI00299;FACTURA;33;2;32272;6132;38404
FAC0030812;2015-09-23;CLI00275;FACTURA;41;2;49432;9392;58824
FAC0030813;2015-08-26;CLI00584;FACTURA;30;1;42820;8136;50956
FAC0030814;2015-03-20;CLI00177;FACTURA;39;2;152635;29001;181636
FAC0030815;2015-01-05;CLI00241;FACTURA;17;2;108284;20574;128858
FAC0030816;2015-12-12;CLI00564;FACTURA;21;1;199854;37972;237826
FAC0030817;2015-04-01;CLI00967;FACTURA;40;2;68724;13058;81782
FAC0030818;2015-04-02;CLI00451;FACTURA;30;2;45104;8570;53674
FAC0030819;2015-11-09;CLI00490;FACTURA;40;1;102010;19382;121392
FAC0030820;2015-02-09;CLI00374;FACTURA;43;1;39730;7549;47279
FAC0030821;2015-02-04;CLI00931;FACTURA;21;2;172676;32808;205484
FAC0030822;2015-04-13;CLI00007;FACTURA;38;2;50766;9646;60412
FAC0030823;2015-08-07;CLI00785;FACTURA;2;2;128460;24407;152867
FAC0030824;2015-03-23;CLI00060;FACTURA;4;1;262128;49804;311932
FAC0030825;2015-07-01;CLI00137;FACTURA;7;2;9446;1795;11241
FAC0030826;2015-08-26;CLI00763;FACTURA;8;2;181112;34411;215523
FAC0030827;2015-01-07;CLI00541;FACTURA;42;2;222060;42191;264251
FAC0030828;2015-02-01;CLI00166;FACTURA;9;1;61206;11629;72835
FAC0030829;2015-04-07;CLI00184;FACTURA;40;1;79749;15152;94901
FAC0030830;2015-01-02;CLI00604;FACTURA;47;1;341870;64955;406825
FAC0030831;2015-05-06;CLI00776;FACTURA;48;1;85524;16250;101774
FAC0030832;2015-03-28;CLI00277;FACTURA;38;2;168776;32067;200843
FAC0030833;2015-04-21;CLI00294;FACTURA;32;1;97530;18531;116061
FAC0030834;2015-03-08;CLI00540;FACTURA;32;1;174872;33226;208098
FAC0030835;2015-02-27;CLI00066;FACTURA;48;1;193963;36853;230816
FAC0030836;2015-03-17;CLI00512;FACTURA;25;1;97530;18531;116061
FAC0030837;2015-04-24;CLI00781;FACTURA;13;2;167985;31917;199902
FAC0030838;2015-09-03;CLI00515;FACTURA;14;2;278432;52902;331334
FAC0030839;2015-08-24;CLI00135;FACTURA;14;2;39012;7412;46424
FAC0030840;2015-04-28;CLI00574;FACTURA;27;1;65577;12460;78037
FAC0030841;2015-11-13;CLI00513;FACTURA;13;2;56691;10771;67462
FAC0030842;2015-09-08;CLI00058;FACTURA;40;1;15892;3019;18911
FAC0030843;2015-04-23;CLI00980;FACTURA;32;1;152298;28937;181235
FAC0030844;2015-11-05;CLI00260;FACTURA;15;1;96816;18395;115211
FAC0030845;2015-06-14;CLI00749;FACTURA;41;2;33844;6430;40274
FAC0030846;2015-11-24;CLI00589;FACTURA;9;2;127365;24199;151564
FAC0030847;2015-07-06;CLI00897;FACTURA;25;2;80680;15329;96009
FAC0030848;2015-05-17;CLI00537;FACTURA;7;2;222060;42191;264251
FAC0030849;2015-10-12;CLI00233;FACTURA;7;2;228730;43459;272189
FAC0030850;2015-09-04;CLI00716;FACTURA;10;1;183087;34787;217874
FAC0030851;2015-11-01;CLI00517;FACTURA;44;2;9446;1795;11241
FAC0030852;2015-10-14;CLI00379;FACTURA;30;2;71670;13617;85287
FAC0030853;2015-04-20;CLI00166;FACTURA;47;1;221672;42118;263790
FAC0030854;2015-05-13;CLI00042;FACTURA;32;1;20147;3828;23975
FAC0030855;2015-12-27;CLI00442;FACTURA;10;1;147819;28086;175905
FAC0030856;2015-11-03;CLI00432;FACTURA;13;1;168936;32098;201034
FAC0030857;2015-02-12;CLI00785;FACTURA;37;2;161360;30658;192018
FAC0030858;2015-02-18;CLI00773;FACTURA;2;2;192690;36611;229301
FAC0030859;2015-09-10;CLI00475;FACTURA;12;2;135355;25717;161072
FAC0030860;2015-04-24;CLI00115;FACTURA;3;2;29003;5511;34514
FAC0030861;2015-05-24;CLI00269;FACTURA;43;2;302373;57451;359824
FAC0030862;2015-04-16;CLI00190;FACTURA;35;1;18892;3589;22481
FAC0030863;2015-04-01;CLI00475;FACTURA;6;2;281110;53411;334521
FAC0030864;2015-02-20;CLI00843;FACTURA;28;2;83127;15794;98921
FAC0030865;2015-01-18;CLI00781;FACTURA;7;2;261027;49595;310622
FAC0030866;2015-01-28;CLI00733;FACTURA;42;2;59136;11236;70372
FAC0030867;2015-06-11;CLI00234;FACTURA;38;1;42820;8136;50956
FAC0030868;2015-01-20;CLI00072;FACTURA;40;1;56691;10771;67462
FAC0030869;2015-07-19;CLI00742;FACTURA;11;1;178311;33879;212190
FAC0030870;2015-05-21;CLI00278;FACTURA;26;1;55622;10568;66190
FAC0030871;2015-06-18;CLI00290;FACTURA;38;1;229257;43559;272816
FAC0030872;2015-11-11;CLI00252;FACTURA;28;1;137238;26075;163313
FAC0030873;2015-01-17;CLI00642;FACTURA;39;1;11454;2176;13630
FAC0030874;2015-05-16;CLI00066;FACTURA;34;1;189497;36004;225501
FAC0030875;2015-12-01;CLI00761;FACTURA;20;2;123066;23383;146449
FAC0030876;2015-08-14;CLI00588;FACTURA;3;1;98452;18706;117158
FAC0030877;2015-08-13;CLI00415;FACTURA;40;2;27071;5143;32214
FAC0030878;2015-01-03;CLI00128;FACTURA;46;1;228654;43444;272098
FAC0030879;2015-07-06;CLI00619;FACTURA;44;2;177648;33753;211401
FAC0030880;2015-12-15;CLI00532;FACTURA;5;1;45104;8570;53674
FAC0030881;2015-03-01;CLI00873;FACTURA;3;2;66618;12657;79275
FAC0030882;2015-04-27;CLI00862;FACTURA;27;1;161176;30623;191799
FAC0030883;2015-09-08;CLI00364;FACTURA;36;1;30850;5862;36712
FAC0030884;2015-03-07;CLI00911;FACTURA;27;2;55611;10566;66177
FAC0030885;2015-03-11;CLI00994;FACTURA;46;1;162744;30921;193665
FAC0030886;2015-07-11;CLI00754;FACTURA;4;1;22908;4353;27261
FAC0030887;2015-04-27;CLI00247;FACTURA;40;2;81372;15461;96833
FAC0030888;2015-07-10;CLI00491;FACTURA;11;2;68374;12991;81365
FAC0030889;2015-10-25;CLI00634;FACTURA;14;1;101192;19226;120418
FAC0030890;2015-11-16;CLI00327;FACTURA;7;2;85524;16250;101774
FAC0030891;2015-04-11;CLI00318;FACTURA;21;1;20958;3982;24940
FAC0030892;2015-09-08;CLI00328;FACTURA;4;1;129006;24511;153517
FAC0030893;2015-05-02;CLI00497;FACTURA;41;2;152298;28937;181235
FAC0030894;2015-05-05;CLI00894;FACTURA;9;1;76032;14446;90478
FAC0030895;2015-02-17;CLI00179;FACTURA;20;2;106332;20203;126535
FAC0030896;2015-11-23;CLI00328;FACTURA;50;1;70544;13403;83947
FAC0030897;2015-09-12;CLI00595;FACTURA;25;2;81213;15430;96643
FAC0030898;2015-11-26;CLI00618;FACTURA;20;1;252999;48070;301069
FAC0030899;2015-10-24;CLI00861;FACTURA;23;2;21097;4008;25105
FAC0030900;2015-05-26;CLI00953;FACTURA;6;2;27709;5265;32974
FAC0030901;2015-03-23;CLI00768;FACTURA;40;1;35272;6702;41974
FAC0030902;2015-06-02;CLI00777;FACTURA;25;2;201470;38279;239749
FAC0030903;2015-03-04;CLI00875;FACTURA;22;2;161176;30623;191799
FAC0030904;2015-05-24;CLI00456;FACTURA;33;1;53166;10102;63268
FAC0030905;2015-01-20;CLI00340;FACTURA;20;1;216568;41148;257716
FAC0030906;2015-12-16;CLI00306;FACTURA;8;1;109295;20766;130061
FAC0030907;2015-03-02;CLI00564;FACTURA;50;1;43190;8206;51396
FAC0030908;2015-12-10;CLI00796;FACTURA;31;1;22908;4353;27261
FAC0030909;2015-01-18;CLI00717;FACTURA;20;2;126702;24073;150775
FAC0030910;2015-06-12;CLI00023;FACTURA;11;2;189497;36004;225501
FAC0030911;2015-02-17;CLI00362;FACTURA;2;1;21805;4143;25948
FAC0030912;2015-02-16;CLI00336;FACTURA;34;1;37784;7179;44963
FAC0030913;2015-06-08;CLI00360;FACTURA;47;1;208824;39677;248501
FAC0030914;2015-03-15;CLI00220;FACTURA;19;1;67688;12861;80549
FAC0030915;2015-08-21;CLI00381;FACTURA;4;2;80178;15234;95412
FAC0030916;2015-02-27;CLI00995;FACTURA;1;2;91809;17444;109253
FAC0030917;2015-07-28;CLI00573;FACTURA;13;2;228654;43444;272098
FAC0030918;2015-05-04;CLI00332;FACTURA;46;1;249381;47382;296763
FAC0030919;2015-10-29;CLI00822;FACTURA;4;1;39730;7549;47279
FAC0030920;2015-08-12;CLI00393;FACTURA;9;2;18537;3522;22059
FAC0030921;2015-11-20;CLI00813;FACTURA;17;2;114540;21763;136303
FAC0030922;2015-01-04;CLI00703;FACTURA;27;2;177842;33790;211632
FAC0030923;2015-11-07;CLI00854;FACTURA;34;1;177648;33753;211401
FAC0030924;2015-07-25;CLI00858;FACTURA;8;1;98452;18706;117158
FAC0030925;2015-03-18;CLI00775;FACTURA;46;2;50766;9646;60412
FAC0030926;2015-04-08;CLI00140;FACTURA;12;1;67584;12841;80425
FAC0030927;2015-10-05;CLI00482;FACTURA;17;1;294894;56030;350924
FAC0030928;2015-07-12;CLI00132;FACTURA;9;1;268776;51067;319843
FAC0030929;2015-02-09;CLI00786;FACTURA;3;1;243639;46291;289930
FAC0030930;2015-08-01;CLI00039;FACTURA;48;2;68370;12990;81360
FAC0030931;2015-04-02;CLI00926;FACTURA;36;1;123452;23456;146908
FAC0030932;2015-06-20;CLI00600;FACTURA;43;1;87436;16613;104049
FAC0030933;2015-12-20;CLI00268;FACTURA;7;1;24716;4696;29412
FAC0030934;2015-05-27;CLI00405;FACTURA;50;2;196731;37379;234110
FAC0030935;2015-10-28;CLI00823;FACTURA;34;2;67194;12767;79961
FAC0030936;2015-05-28;CLI00804;FACTURA;18;1;249381;47382;296763
FAC0030937;2015-07-04;CLI00976;FACTURA;25;1;47676;9058;56734
FAC0030938;2015-08-02;CLI00315;FACTURA;2;2;65532;12451;77983
FAC0030939;2015-05-24;CLI00245;FACTURA;31;2;189497;36004;225501
FAC0030940;2015-12-10;CLI00737;FACTURA;24;2;67584;12841;80425
FAC0030941;2015-03-10;CLI00223;FACTURA;20;2;105585;20061;125646
FAC0030942;2015-09-06;CLI00147;FACTURA;47;2;64544;12263;76807
FAC0030943;2015-05-03;CLI00742;FACTURA;49;1;307683;58460;366143
FAC0030944;2015-08-25;CLI00239;FACTURA;47;2;29003;5511;34514
FAC0030945;2015-01-18;CLI00549;FACTURA;20;2;71670;13617;85287
FAC0030946;2015-12-15;CLI00188;FACTURA;20;1;33792;6420;40212
FAC0030947;2015-03-29;CLI00295;FACTURA;16;2;277090;52647;329737
FAC0030948;2015-08-28;CLI00342;FACTURA;35;1;168666;32047;200713
FAC0030949;2015-01-05;CLI00330;FACTURA;24;1;102010;19382;121392
FAC0030950;2015-05-31;CLI00106;FACTURA;45;1;9446;1795;11241
FAC0030951;2015-08-02;CLI00007;FACTURA;9;2;32272;6132;38404
FAC0030952;2015-06-16;CLI00273;FACTURA;39;2;16922;3215;20137
FAC0030953;2015-08-18;CLI00011;FACTURA;10;2;243628;46289;289917
FAC0030954;2015-11-27;CLI00537;FACTURA;18;2;61700;11723;73423
FAC0030955;2015-08-27;CLI00565;FACTURA;9;2;33597;6383;39980
FAC0030956;2015-01-06;CLI00927;FACTURA;44;2;27709;5265;32974
FAC0030957;2015-02-17;CLI00300;FACTURA;9;1;195060;37061;232121
FAC0030958;2015-06-20;CLI00069;FACTURA;6;2;83419;15850;99269
FAC0030959;2015-04-19;CLI00124;FACTURA;43;1;186081;35355;221436
FAC0030960;2015-07-17;CLI00277;FACTURA;25;2;136542;25943;162485
FAC0030961;2015-05-15;CLI00523;FACTURA;27;2;161360;30658;192018
FAC0030962;2015-03-17;CLI00145;FACTURA;19;2;277090;52647;329737
FAC0030963;2015-08-31;CLI00059;FACTURA;12;2;216568;41148;257716
FAC0030964;2015-05-07;CLI00744;FACTURA;30;1;69420;13190;82610
FAC0030965;2015-07-01;CLI00964;FACTURA;6;1;71670;13617;85287
FAC0030966;2015-07-19;CLI00428;FACTURA;40;1;221517;42088;263605
FAC0030967;2015-11-03;CLI00383;FACTURA;3;2;235179;44684;279863
FAC0030968;2015-11-15;CLI00842;FACTURA;32;1;118454;22506;140960
FAC0030969;2015-05-13;CLI00081;FACTURA;19;2;61206;11629;72835
FAC0030970;2015-03-25;CLI00308;FACTURA;29;1;85014;16153;101167
FAC0030971;2015-06-06;CLI00685;FACTURA;40;2;208824;39677;248501
FAC0030972;2015-11-17;CLI00233;FACTURA;4;2;106332;20203;126535
FAC0030973;2015-11-17;CLI00048;FACTURA;30;1;83419;15850;99269
FAC0030974;2015-04-29;CLI00013;FACTURA;20;2;81608;15506;97114
FAC0030975;2015-03-22;CLI00404;FACTURA;28;1;159498;30305;189803
FAC0030976;2015-01-05;CLI00926;FACTURA;26;1;43002;8170;51172
FAC0030977;2015-06-29;CLI00095;FACTURA;15;2;181323;34451;215774
FAC0030978;2015-04-24;CLI00474;FACTURA;47;1;128280;24373;152653
FAC0030979;2015-08-08;CLI00729;FACTURA;20;2;114365;21729;136094
FAC0030980;2015-05-19;CLI00271;FACTURA;25;2;147678;28059;175737
FAC0030981;2015-08-18;CLI00913;FACTURA;10;2;96210;18280;114490
FAC0030982;2015-01-15;CLI00217;FACTURA;47;2;138840;26380;165220
FAC0030983;2015-10-23;CLI00415;FACTURA;31;2;109025;20715;129740
FAC0030984;2015-03-28;CLI00716;FACTURA;22;1;101715;19326;121041
FAC0030985;2015-11-30;CLI00929;FACTURA;17;2;57270;10881;68151
FAC0030986;2015-10-28;CLI00326;FACTURA;29;1;16035;3047;19082
FAC0030987;2015-10-23;CLI00765;FACTURA;44;2;228064;43332;271396
FAC0030988;2015-07-22;CLI00261;FACTURA;47;2;272430;51762;324192
FAC0030989;2015-11-06;CLI00782;FACTURA;1;1;177842;33790;211632
FAC0030990;2015-08-25;CLI00663;FACTURA;2;2;181112;34411;215523
FAC0030991;2015-10-04;CLI00505;FACTURA;40;2;139216;26451;165667
FAC0030992;2015-08-27;CLI00516;FACTURA;32;1;182984;34767;217751
FAC0030993;2015-07-25;CLI00298;FACTURA;40;1;24613;4676;29289
FAC0030994;2015-04-30;CLI00373;FACTURA;27;2;81213;15430;96643
FAC0030995;2015-02-11;CLI00186;FACTURA;5;1;15892;3019;18911
FAC0030996;2015-04-19;CLI00172;FACTURA;7;1;31437;5973;37410
FAC0030997;2015-10-02;CLI00273;FACTURA;40;2;133236;25315;158551
FAC0030998;2015-01-20;CLI00838;FACTURA;24;1;106332;20203;126535
FAC0030999;2015-10-25;CLI00260;FACTURA;6;1;136740;25981;162721
FAC0031000;2015-12-03;CLI00156;FACTURA;19;1;23834;4528;28362
FAC0031001;2015-04-23;CLI00587;FACTURA;38;2;8448;1605;10053
FAC0031002;2015-12-20;CLI00146;FACTURA;43;1;76419;14520;90939
FAC0031003;2015-04-08;CLI00595;FACTURA;20;2;126582;24051;150633
FAC0031004;2015-09-29;CLI00134;FACTURA;17;1;100735;19140;119875
FAC0031005;2015-12-10;CLI00394;FACTURA;23;1;56222;10682;66904
FAC0031006;2015-01-08;CLI00046;FACTURA;49;1;49336;9374;58710
FAC0031007;2015-12-19;CLI00222;FACTURA;34;1;33792;6420;40212
FAC0031008;2015-08-03;CLI00507;FACTURA;8;2;214100;40679;254779
FAC0031009;2015-01-25;CLI00994;FACTURA;21;1;66618;12657;79275
FAC0031010;2015-06-01;CLI00757;FACTURA;2;2;158724;30158;188882
FAC0031011;2015-10-01;CLI00416;FACTURA;33;1;85640;16272;101912
FAC0031012;2015-05-09;CLI00264;FACTURA;2;1;183087;34787;217874
FAC0031013;2015-02-06;CLI00929;FACTURA;27;2;88180;16754;104934
FAC0031014;2015-10-06;CLI00598;FACTURA;5;1;153013;29072;182085
FAC0031015;2015-02-06;CLI00617;FACTURA;44;2;47415;9009;56424
FAC0031016;2015-05-24;CLI00710;FACTURA;46;1;136542;25943;162485
FAC0031017;2015-08-11;CLI00156;FACTURA;7;1;136542;25943;162485
FAC0031018;2015-01-29;CLI00250;FACTURA;10;1;149870;28475;178345
FAC0031019;2015-12-08;CLI00480;FACTURA;16;1;193963;36853;230816
FAC0031020;2015-09-13;CLI00642;FACTURA;8;1;25344;4815;30159
FAC0031021;2015-05-11;CLI00982;FACTURA;38;1;177648;33753;211401
FAC0031022;2015-05-01;CLI00755;FACTURA;30;2;137238;26075;163313
FAC0031023;2015-01-31;CLI00804;FACTURA;49;1;142540;27083;169623
FAC0031024;2015-11-06;CLI00743;FACTURA;10;2;54696;10392;65088
FAC0031025;2015-04-03;CLI00097;FACTURA;13;2;12358;2348;14706
FAC0031026;2015-09-12;CLI00220;FACTURA;13;1;54142;10287;64429
FAC0031027;2015-10-28;CLI00044;FACTURA;39;1;10146;1928;12074
FAC0031028;2015-09-20;CLI00596;FACTURA;29;1;252999;48070;301069
FAC0031029;2015-02-24;CLI00345;FACTURA;26;2;75894;14420;90314
FAC0031030;2015-11-02;CLI00855;FACTURA;13;2;109392;20784;130176
FAC0031031;2015-06-09;CLI00058;FACTURA;12;1;201470;38279;239749
FAC0031032;2015-02-19;CLI00042;FACTURA;22;1;53166;10102;63268
FAC0031033;2015-07-21;CLI00453;FACTURA;43;2;123452;23456;146908
FAC0031034;2015-12-12;CLI00086;FACTURA;24;1;221672;42118;263790
FAC0031035;2015-05-13;CLI00542;FACTURA;3;1;214100;40679;254779
FAC0031036;2015-03-19;CLI00755;FACTURA;7;2;91492;17383;108875
FAC0031037;2015-04-30;CLI00395;FACTURA;19;2;203784;38719;242503
FAC0031038;2015-12-06;CLI00841;FACTURA;23;2;94311;17919;112230
FAC0031039;2015-08-05;CLI00971;FACTURA;34;2;42820;8136;50956
FAC0031040;2015-01-03;CLI00684;FACTURA;5;1;50812;9654;60466
FAC0031041;2015-04-23;CLI00464;FACTURA;38;1;50688;9631;60319
FAC0031042;2015-07-21;CLI00245;FACTURA;25;2;39466;7499;46965
FAC0031043;2015-02-07;CLI00914;FACTURA;36;1;45278;8603;53881
FAC0031044;2015-09-28;CLI00787;FACTURA;14;2;136740;25981;162721
FAC0031045;2015-01-16;CLI00852;FACTURA;18;1;21410;4068;25478
FAC0031046;2015-12-24;CLI00403;FACTURA;29;2;21097;4008;25105
FAC0031047;2015-03-22;CLI00795;FACTURA;15;2;227682;43260;270942
FAC0031048;2015-05-15;CLI00553;FACTURA;24;2;51005;9691;60696
FAC0031049;2015-03-31;CLI00455;FACTURA;39;2;277090;52647;329737
FAC0031050;2015-10-02;CLI00215;FACTURA;27;2;56380;10712;67092
FAC0031051;2015-10-18;CLI00456;FACTURA;41;1;63568;12078;75646
FAC0031052;2015-06-17;CLI00249;FACTURA;44;2;203784;38719;242503
FAC0031053;2015-02-23;CLI00759;FACTURA;12;2;83419;15850;99269
FAC0031054;2015-12-16;CLI00019;FACTURA;44;2;42194;8017;50211
FAC0031055;2015-07-05;CLI00581;FACTURA;47;2;55622;10568;66190
FAC0031056;2015-11-02;CLI00159;FACTURA;17;2;73839;14029;87868
FAC0031057;2015-07-17;CLI00157;FACTURA;6;2;249381;47382;296763
FAC0031058;2015-09-10;CLI00952;FACTURA;26;1;151788;28840;180628
FAC0031059;2015-08-15;CLI00827;FACTURA;16;2;112245;21327;133572
FAC0031060;2015-12-31;CLI00513;FACTURA;20;2;26583;5051;31634
FAC0031061;2015-07-29;CLI00872;FACTURA;13;1;104790;19910;124700
FAC0031062;2015-10-07;CLI00065;FACTURA;6;2;56898;10811;67709
FAC0031063;2015-09-29;CLI00686;FACTURA;5;1;199854;37972;237826
FAC0031064;2015-06-25;CLI00415;FACTURA;41;2;24680;4689;29369
FAC0031065;2015-05-31;CLI00555;FACTURA;14;2;242970;46164;289134
FAC0031066;2015-11-20;CLI00108;FACTURA;23;1;55530;10551;66081
FAC0031067;2015-03-11;CLI00820;FACTURA;30;1;68370;12990;81360
FAC0031068;2015-03-15;CLI00498;FACTURA;43;1;118454;22506;140960
FAC0031069;2015-07-08;CLI00420;FACTURA;4;1;252999;48070;301069
FAC0031070;2015-07-27;CLI00674;FACTURA;22;1;203021;38574;241595
FAC0031071;2015-05-10;CLI00989;FACTURA;24;2;67584;12841;80425
FAC0031072;2015-09-26;CLI00682;FACTURA;46;1;80680;15329;96009
FAC0031073;2015-12-28;CLI00303;FACTURA;16;2;136740;25981;162721
FAC0031074;2015-03-30;CLI00189;FACTURA;8;2;57016;10833;67849
FAC0031075;2015-01-18;CLI00289;FACTURA;37;2;28508;5417;33925
FAC0031076;2015-04-30;CLI00801;FACTURA;3;2;82044;15588;97632
FAC0031077;2015-03-03;CLI00955;FACTURA;39;2;105485;20042;125527
FAC0031078;2015-01-21;CLI00791;FACTURA;5;2;41916;7964;49880
FAC0031079;2015-12-01;CLI00983;FACTURA;45;2;108284;20574;128858
FAC0031080;2015-06-21;CLI00167;FACTURA;41;2;65577;12460;78037
FAC0031081;2015-01-20;CLI00304;FACTURA;1;1;158724;30158;188882
FAC0031082;2015-03-21;CLI00256;FACTURA;32;1;35272;6702;41974
FAC0031083;2015-04-15;CLI00608;FACTURA;23;1;24716;4696;29412
FAC0031084;2015-02-03;CLI00101;FACTURA;25;2;49432;9392;58824
FAC0031085;2015-11-04;CLI00627;FACTURA;4;2;103086;19586;122672
FAC0031086;2015-04-11;CLI00879;FACTURA;19;2;127365;24199;151564
FAC0031087;2015-07-05;CLI00586;FACTURA;38;1;172291;32735;205026
FAC0031088;2015-11-19;CLI00915;FACTURA;41;2;172291;32735;205026
FAC0031089;2015-10-31;CLI00025;FACTURA;42;2;55611;10566;66177
FAC0031090;2015-08-18;CLI00648;FACTURA;14;1;130830;24858;155688
FAC0031091;2015-05-24;CLI00501;FACTURA;2;2;256572;48749;305321
FAC0031092;2015-09-14;CLI00270;FACTURA;5;1;156048;29649;185697
FAC0031093;2015-03-13;CLI00896;FACTURA;50;1;212664;40406;253070
FAC0031094;2015-12-04;CLI00843;FACTURA;5;2;40804;7753;48557
FAC0031095;2015-01-30;CLI00449;FACTURA;15;2;64230;12204;76434
FAC0031096;2015-01-19;CLI00811;FACTURA;48;2;24716;4696;29412
FAC0031097;2015-12-11;CLI00561;FACTURA;44;2;63291;12025;75316
FAC0031098;2015-02-09;CLI00059;FACTURA;28;2;43002;8170;51172
FAC0031099;2015-08-05;CLI00680;FACTURA;30;1;152635;29001;181636
FAC0031100;2015-09-29;CLI00752;FACTURA;14;1;98452;18706;117158
FAC0031101;2015-08-19;CLI00401;FACTURA;4;2;20147;3828;23975
FAC0031102;2015-06-24;CLI00921;FACTURA;3;2;24716;4696;29412
FAC0031103;2015-10-06;CLI00950;FACTURA;33;1;54696;10392;65088
FAC0031104;2015-02-10;CLI00258;FACTURA;1;1;273496;51964;325460
FAC0031105;2015-04-22;CLI00467;FACTURA;25;2;37932;7207;45139
FAC0031106;2015-06-09;CLI00227;FACTURA;50;2;118454;22506;140960
FAC0031107;2015-07-28;CLI00996;FACTURA;23;1;335970;63834;399804
FAC0031108;2015-09-01;CLI00417;FACTURA;50;2;22873;4346;27219
FAC0031109;2015-12-16;CLI00339;FACTURA;4;2;245187;46586;291773
FAC0031110;2015-03-29;CLI00614;FACTURA;25;1;254060;48271;302331
FAC0031111;2015-11-24;CLI00725;FACTURA;7;2;177086;33646;210732
FAC0031112;2015-10-16;CLI00066;FACTURA;10;1;123340;23435;146775
FAC0031113;2015-05-12;CLI00623;FACTURA;32;2;55530;10551;66081
FAC0031114;2015-05-10;CLI00495;FACTURA;38;2;80680;15329;96009
FAC0031115;2015-01-19;CLI00324;FACTURA;3;1;24613;4676;29289
FAC0031116;2015-09-29;CLI00418;FACTURA;28;1;159498;30305;189803
FAC0031117;2015-06-18;CLI00124;FACTURA;11;1;221517;42088;263605
FAC0031118;2015-08-21;CLI00680;FACTURA;7;1;37784;7179;44963
FAC0031119;2015-04-16;CLI00223;FACTURA;6;2;50596;9613;60209
FAC0031120;2015-05-31;CLI00744;FACTURA;9;1;86004;16341;102345
FAC0031121;2015-10-28;CLI00783;FACTURA;17;2;43190;8206;51396
FAC0031122;2015-03-13;CLI00937;FACTURA;10;2;28449;5405;33854
FAC0031123;2015-03-22;CLI00519;FACTURA;40;2;203784;38719;242503
FAC0031124;2015-04-18;CLI00852;FACTURA;47;1;31437;5973;37410
FAC0031125;2015-11-01;CLI00068;FACTURA;12;1;81729;15529;97258
FAC0031126;2015-03-20;CLI00662;FACTURA;23;1;114032;21666;135698
FAC0031127;2015-05-19;CLI00018;FACTURA;40;1;60876;11566;72442
FAC0031128;2015-08-19;CLI00770;FACTURA;4;1;126490;24033;150523
FAC0031129;2015-08-08;CLI00755;FACTURA;9;2;43190;8206;51396
FAC0031130;2015-07-06;CLI00793;FACTURA;5;2;54486;10352;64838
FAC0031131;2015-12-10;CLI00976;FACTURA;37;1;147819;28086;175905
FAC0031132;2015-10-12;CLI00023;FACTURA;38;2;144315;27420;171735
FAC0031133;2015-05-07;CLI00263;FACTURA;5;2;249381;47382;296763
FAC0031134;2015-10-09;CLI00810;FACTURA;35;1;25406;4827;30233
FAC0031135;2015-11-13;CLI00646;FACTURA;22;1;128460;24407;152867
FAC0031136;2015-04-14;CLI00815;FACTURA;26;2;109392;20784;130176
FAC0031137;2015-10-27;CLI00640;FACTURA;27;1;34804;6613;41417
FAC0031138;2015-11-05;CLI00352;FACTURA;8;1;61029;11596;72625
FAC0031139;2015-03-31;CLI00462;FACTURA;14;1;94460;17947;112407
FAC0031140;2015-04-09;CLI00028;FACTURA;5;1;56380;10712;67092
FAC0031141;2015-07-06;CLI00028;FACTURA;1;1;57016;10833;67849
FAC0031142;2015-08-14;CLI00202;FACTURA;9;1;18537;3522;22059
FAC0031143;2015-06-28;CLI00222;FACTURA;16;1;147679;28059;175738
FAC0031144;2015-01-12;CLI00210;FACTURA;1;1;37074;7044;44118
FAC0031145;2015-01-13;CLI00901;FACTURA;47;2;81168;15422;96590
FAC0031146;2015-11-03;CLI00514;FACTURA;16;1;113195;21507;134702
FAC0031147;2015-11-17;CLI00426;FACTURA;32;1;45278;8603;53881
FAC0031148;2015-09-25;CLI00534;FACTURA;9;1;60876;11566;72442
FAC0031149;2015-01-29;CLI00573;FACTURA;21;2;347100;65949;413049
FAC0031150;2015-05-12;CLI00208;FACTURA;44;1;28668;5447;34115
FAC0031151;2015-08-19;CLI00986;FACTURA;21;1;203430;38652;242082
FAC0031152;2015-07-31;CLI00260;FACTURA;49;1;134388;25534;159922
FAC0031153;2015-03-28;CLI00726;FACTURA;47;1;12358;2348;14706
FAC0031154;2015-05-01;CLI00484;FACTURA;13;1;199556;37916;237472
FAC0031155;2015-04-10;CLI00966;FACTURA;15;1;65415;12429;77844
FAC0031156;2015-07-22;CLI00654;FACTURA;46;1;139216;26451;165667
FAC0031157;2015-10-18;CLI00781;FACTURA;26;2;53166;10102;63268
FAC0031158;2015-10-01;CLI00700;FACTURA;6;1;28190;5356;33546
FAC0031159;2015-08-26;CLI00473;FACTURA;24;2;20292;3855;24147
FAC0031160;2015-05-22;CLI00448;FACTURA;11;1;174018;33063;207081
FAC0031161;2015-12-05;CLI00112;FACTURA;11;1;34710;6595;41305
FAC0031162;2015-01-03;CLI00767;FACTURA;17;2;63568;12078;75646
FAC0031163;2015-09-25;CLI00873;FACTURA;21;2;27071;5143;32214
FAC0031164;2015-12-01;CLI00611;FACTURA;29;2;7946;1510;9456
FAC0031165;2015-03-06;CLI00415;FACTURA;39;2;84333;16023;100356
FAC0031166;2015-10-12;CLI00437;FACTURA;27;2;243628;46289;289917
FAC0031167;2015-06-18;CLI00174;FACTURA;42;1;40804;7753;48557
FAC0031168;2015-02-28;CLI00332;FACTURA;7;1;56898;10811;67709
FAC0031169;2015-02-23;CLI00098;FACTURA;24;1;86004;16341;102345
FAC0031170;2015-05-15;CLI00151;FACTURA;48;2;67194;12767;79961
FAC0031171;2015-05-15;CLI00424;FACTURA;36;1;158724;30158;188882
FAC0031172;2015-02-01;CLI00457;FACTURA;26;2;212664;40406;253070
FAC0031173;2015-05-11;CLI00740;FACTURA;40;1;229257;43559;272816
FAC0031174;2015-01-11;CLI00653;FACTURA;26;2;21117;4012;25129
FAC0031175;2015-10-06;CLI00366;FACTURA;17;1;126582;24051;150633
FAC0031176;2015-10-10;CLI00749;FACTURA;12;2;20147;3828;23975
FAC0031177;2015-02-13;CLI00104;FACTURA;12;1;101532;19291;120823
FAC0031178;2015-10-15;CLI00852;FACTURA;13;1;203751;38713;242464
FAC0031179;2015-10-23;CLI00510;FACTURA;39;1;224888;42729;267617
FAC0031180;2015-12-31;CLI00429;FACTURA;19;2;41916;7964;49880
FAC0031181;2015-07-14;CLI00824;FACTURA;50;1;50730;9639;60369
FAC0031182;2015-10-17;CLI00850;FACTURA;4;1;27348;5196;32544
FAC0031183;2015-06-09;CLI00410;FACTURA;17;1;95336;18114;113450
FAC0031184;2015-10-02;CLI00776;FACTURA;17;1;114672;21788;136460
FAC0031185;2015-01-19;CLI00270;FACTURA;43;1;277090;52647;329737
FAC0031186;2015-04-13;CLI00461;FACTURA;29;2;98672;18748;117420
FAC0031187;2015-03-07;CLI00275;FACTURA;38;2;113382;21543;134925
FAC0031188;2015-07-11;CLI00808;FACTURA;38;1;178311;33879;212190
FAC0031189;2015-11-23;CLI00032;FACTURA;46;1;228064;43332;271396
FAC0031190;2015-01-06;CLI00426;FACTURA;30;1;26583;5051;31634
FAC0031191;2015-07-12;CLI00091;FACTURA;33;2;160350;30467;190817
FAC0031192;2015-08-07;CLI00769;FACTURA;44;2;71514;13588;85102
FAC0031193;2015-10-29;CLI00693;FACTURA;40;2;14334;2723;17057
FAC0031194;2015-06-10;CLI00472;FACTURA;49;1;69608;13226;82834
FAC0031195;2015-12-08;CLI00259;FACTURA;2;2;142401;27056;169457
FAC0031196;2015-05-19;CLI00040;FACTURA;9;1;64140;12187;76327
FAC0031197;2015-10-20;CLI00817;FACTURA;33;2;147679;28059;175738
FAC0031198;2015-07-22;CLI00015;FACTURA;39;2;100338;19064;119402
FAC0031199;2015-11-09;CLI00491;FACTURA;36;2;18537;3522;22059
FAC0031200;2015-10-13;CLI00453;FACTURA;35;2;91632;17410;109042
FAC0031201;2015-09-04;CLI00937;FACTURA;21;2;221517;42088;263605
FAC0031202;2015-06-18;CLI00657;FACTURA;35;2;63351;12037;75388
FAC0031203;2015-10-30;CLI00548;FACTURA;17;1;218050;41430;259480
FAC0031204;2015-08-23;CLI00692;FACTURA;41;1;160111;30421;190532
FAC0031205;2015-05-03;CLI00782;FACTURA;42;1;228730;43459;272189
FAC0031206;2015-01-09;CLI00828;FACTURA;48;1;74004;14061;88065
FAC0031207;2015-10-18;CLI00267;FACTURA;21;2;205857;39113;244970
FAC0031208;2015-07-12;CLI00376;FACTURA;47;1;57336;10894;68230
FAC0031209;2015-06-26;CLI00263;FACTURA;15;2;112245;21327;133572
FAC0031210;2015-01-14;CLI00570;FACTURA;42;1;186081;35355;221436
FAC0031211;2015-07-08;CLI00071;FACTURA;17;2;37794;7181;44975
FAC0031212;2015-06-23;CLI00474;FACTURA;24;1;9483;1802;11285
FAC0031213;2015-12-27;CLI00879;FACTURA;37;2;189497;36004;225501
FAC0031214;2015-10-27;CLI00514;FACTURA;15;1;66381;12612;78993
FAC0031215;2015-11-09;CLI00805;FACTURA;46;2;312390;59354;371744
FAC0031216;2015-02-26;CLI00249;FACTURA;50;2;47415;9009;56424
FAC0031217;2015-11-09;CLI00140;FACTURA;39;1;68370;12990;81360
FAC0031218;2015-11-23;CLI00572;FACTURA;17;1;64140;12187;76327
FAC0031219;2015-01-08;CLI00064;FACTURA;6;1;140555;26705;167260
FAC0031220;2015-08-30;CLI00637;FACTURA;19;2;135834;25808;161642
FAC0031221;2015-07-02;CLI00274;FACTURA;30;1;28338;5384;33722
FAC0031222;2015-05-04;CLI00033;FACTURA;44;2;98672;18748;117420
FAC0031223;2015-11-28;CLI00424;FACTURA;35;1;79460;15097;94557
FAC0031224;2015-02-13;CLI00011;FACTURA;20;2;141088;26807;167895
FAC0031225;2015-06-05;CLI00450;FACTURA;45;1;181112;34411;215523
FAC0031226;2015-01-30;CLI00790;FACTURA;40;1;50742;9641;60383
FAC0031227;2015-06-07;CLI00034;FACTURA;12;1;41022;7794;48816
FAC0031228;2015-01-14;CLI00783;FACTURA;27;2;246680;46869;293549
FAC0031229;2015-02-18;CLI00122;FACTURA;1;1;272430;51762;324192
FAC0031230;2015-10-03;CLI00289;FACTURA;44;2;104412;19838;124250
FAC0031231;2015-04-20;CLI00968;FACTURA;24;1;81168;15422;96590
FAC0031232;2015-09-30;CLI00593;FACTURA;12;2;348040;66128;414168
FAC0031233;2015-06-05;CLI00457;FACTURA;47;2;116012;22042;138054
FAC0031234;2015-01-03;CLI00880;FACTURA;43;1;141029;26796;167825
FAC0031235;2015-04-29;CLI00094;FACTURA;7;1;168666;32047;200713
FAC0031236;2015-09-18;CLI00698;FACTURA;38;1;104790;19910;124700
FAC0031237;2015-08-05;CLI00942;FACTURA;3;1;178311;33879;212190
FAC0031238;2015-08-23;CLI00157;FACTURA;43;2;60876;11566;72442
FAC0031239;2015-01-31;CLI00500;FACTURA;10;1;131154;24919;156073
FAC0031240;2015-07-22;CLI00139;FACTURA;50;2;104790;19910;124700
FAC0031241;2015-07-31;CLI00950;FACTURA;48;1;30850;5862;36712
FAC0031242;2015-12-20;CLI00218;FACTURA;3;1;129006;24511;153517
FAC0031243;2015-04-27;CLI00869;FACTURA;11;2;71670;13617;85287
FAC0031244;2015-10-10;CLI00628;FACTURA;16;1;16035;3047;19082
FAC0031245;2015-07-27;CLI00106;FACTURA;20;1;9446;1795;11241
FAC0031246;2015-01-05;CLI00321;FACTURA;49;2;27709;5265;32974
FAC0031247;2015-10-22;CLI00468;FACTURA;19;1;222012;42182;264194
FAC0031248;2015-10-02;CLI00642;FACTURA;15;1;106332;20203;126535
FAC0031249;2015-03-21;CLI00539;FACTURA;3;2;75568;14358;89926
FAC0031250;2015-03-22;CLI00652;FACTURA;49;1;32272;6132;38404
FAC0031251;2015-04-18;CLI00471;FACTURA;45;2;84388;16034;100422
FAC0031252;2015-08-21;CLI00753;FACTURA;12;2;119170;22642;141812
FAC0031253;2015-12-08;CLI00042;FACTURA;24;1;290030;55106;345136
FAC0031254;2015-04-04;CLI00197;FACTURA;3;2;11917;2264;14181
FAC0031255;2015-10-16;CLI00564;FACTURA;15;1;57336;10894;68230
FAC0031256;2015-03-19;CLI00141;FACTURA;38;2;148008;28122;176130
FAC0031257;2015-03-30;CLI00043;FACTURA;45;2;126582;24051;150633
FAC0031258;2015-01-11;CLI00787;FACTURA;18;2;129006;24511;153517
FAC0031259;2015-02-02;CLI00920;FACTURA;34;1;10201;1938;12139
FAC0031260;2015-01-19;CLI00323;FACTURA;26;2;85014;16153;101167
FAC0031261;2015-06-04;CLI00275;FACTURA;50;2;218050;41430;259480
FAC0031262;2015-12-07;CLI00037;FACTURA;46;2;139216;26451;165667
FAC0031263;2015-05-30;CLI00842;FACTURA;14;1;193963;36853;230816
FAC0031264;2015-07-23;CLI00110;FACTURA;23;1;135834;25808;161642
FAC0031265;2015-01-13;CLI00196;FACTURA;42;1;21117;4012;25129
FAC0031266;2015-08-02;CLI00415;FACTURA;39;2;40804;7753;48557
FAC0031267;2015-12-05;CLI00176;FACTURA;40;1;228654;43444;272098
FAC0031268;2015-12-16;CLI00217;FACTURA;13;2;55622;10568;66190
FAC0031269;2015-04-15;CLI00148;FACTURA;13;1;47676;9058;56734
FAC0031270;2015-07-07;CLI00267;FACTURA;37;2;134388;25534;159922
FAC0031271;2015-10-27;CLI00373;FACTURA;42;2;69608;13226;82834
FAC0031272;2015-05-02;CLI00618;FACTURA;2;1;196596;37353;233949
FAC0031273;2015-10-28;CLI00282;FACTURA;32;1;56222;10682;66904
FAC0031274;2015-11-10;CLI00582;FACTURA;42;1;35272;6702;41974
FAC0031275;2015-05-10;CLI00954;FACTURA;37;1;21117;4012;25129
FAC0031276;2015-12-10;CLI00164;FACTURA;9;1;229362;43579;272941
FAC0031277;2015-01-18;CLI00092;FACTURA;47;1;26583;5051;31634
FAC0031278;2015-01-11;CLI00152;FACTURA;49;1;152436;28963;181399
FAC0031279;2015-05-31;CLI00403;FACTURA;34;2;71502;13585;85087
FAC0031280;2015-09-13;CLI00684;FACTURA;7;1;76032;14446;90478
FAC0031281;2015-08-23;CLI00447;FACTURA;14;2;87220;16572;103792
FAC0031282;2015-07-26;CLI00288;FACTURA;32;1;168666;32047;200713
FAC0031283;2015-10-30;CLI00636;FACTURA;6;1;22552;4285;26837
FAC0031284;2015-05-26;CLI00094;FACTURA;29;1;174440;33144;207584
FAC0031285;2015-04-16;CLI00369;FACTURA;7;2;81608;15506;97114
FAC0031286;2015-09-07;CLI00297;FACTURA;6;2;158724;30158;188882
FAC0031287;2015-04-02;CLI00370;FACTURA;7;1;22206;4219;26425
FAC0031288;2015-01-14;CLI00837;FACTURA;19;2;84333;16023;100356
FAC0031289;2015-08-23;CLI00588;FACTURA;23;1;11917;2264;14181
FAC0031290;2015-04-29;CLI00790;FACTURA;17;1;104130;19785;123915
FAC0031291;2015-05-01;CLI00720;FACTURA;50;1;95336;18114;113450
FAC0031292;2015-01-02;CLI00023;FACTURA;45;2;128460;24407;152867
FAC0031293;2015-06-15;CLI00755;FACTURA;21;2;181112;34411;215523
FAC0031294;2015-07-16;CLI00181;FACTURA;5;2;182984;34767;217751
FAC0031295;2015-01-13;CLI00323;FACTURA;34;2;27243;5176;32419
FAC0031296;2015-12-13;CLI00602;FACTURA;35;1;112245;21327;133572
FAC0031297;2015-06-12;CLI00916;FACTURA;48;1;30438;5783;36221
FAC0031298;2015-03-21;CLI00910;FACTURA;40;1;110836;21059;131895
FAC0031299;2015-05-14;CLI00464;FACTURA;17;1;67584;12841;80425
FAC0031300;2015-08-26;CLI00696;FACTURA;44;1;245187;46586;291773
FAC0031301;2015-02-27;CLI00624;FACTURA;16;1;60876;11566;72442
FAC0031302;2015-06-14;CLI00522;FACTURA;26;1;84333;16023;100356
FAC0031303;2015-10-19;CLI00134;FACTURA;39;1;116012;22042;138054
FAC0031304;2015-10-12;CLI00184;FACTURA;2;1;55622;10568;66190
FAC0031305;2015-06-12;CLI00308;FACTURA;46;1;211170;40122;251292
FAC0031306;2015-11-26;CLI00941;FACTURA;9;2;52908;10053;62961
FAC0031307;2015-01-24;CLI00969;FACTURA;1;2;178311;33879;212190
FAC0031308;2015-02-23;CLI00543;FACTURA;6;2;43610;8286;51896
FAC0031309;2015-07-05;CLI00949;FACTURA;20;2;21805;4143;25948
FAC0031310;2015-05-02;CLI00172;FACTURA;36;1;152635;29001;181636
FAC0031311;2015-09-24;CLI00335;FACTURA;33;2;102561;19487;122048
FAC0031312;2015-12-28;CLI00173;FACTURA;47;2;139216;26451;165667
FAC0031313;2015-08-26;CLI00683;FACTURA;24;2;101892;19359;121251
FAC0031314;2015-01-16;CLI00268;FACTURA;10;1;113195;21507;134702
FAC0031315;2015-06-02;CLI00970;FACTURA;8;1;21097;4008;25105
FAC0031316;2015-12-18;CLI00623;FACTURA;7;2;55611;10566;66177
FAC0031317;2015-03-21;CLI00190;FACTURA;34;1;20958;3982;24940
FAC0031318;2015-05-01;CLI00723;FACTURA;48;2;81608;15506;97114
FAC0031319;2015-06-18;CLI00972;FACTURA;20;1;245187;46586;291773
FAC0031320;2015-03-06;CLI00629;FACTURA;7;2;71670;13617;85287
FAC0031321;2015-06-28;CLI00898;FACTURA;25;1;50946;9680;60626
FAC0031322;2015-09-29;CLI00576;FACTURA;1;1;47676;9058;56734
FAC0031323;2015-10-14;CLI00879;FACTURA;48;2;243628;46289;289917
FAC0031324;2015-03-05;CLI00469;FACTURA;35;2;39466;7499;46965
FAC0031325;2015-02-05;CLI00483;FACTURA;15;2;50742;9641;60383
FAC0031326;2015-05-23;CLI00044;FACTURA;15;1;57336;10894;68230
FAC0031327;2015-07-26;CLI00402;FACTURA;46;1;123065;23382;146447
FAC0031328;2015-06-15;CLI00651;FACTURA;32;2;104412;19838;124250
FAC0031329;2015-01-16;CLI00123;FACTURA;18;2;239247;45457;284704
FAC0031330;2015-01-07;CLI00273;FACTURA;20;2;341870;64955;406825
FAC0031331;2015-12-05;CLI00571;FACTURA;49;2;16136;3066;19202
FAC0031332;2015-03-23;CLI00509;FACTURA;17;2;51005;9691;60696
FAC0031333;2015-01-21;CLI00366;FACTURA;1;1;277090;52647;329737
FAC0031334;2015-03-23;CLI00459;FACTURA;12;2;76032;14446;90478
FAC0031335;2015-03-03;CLI00669;FACTURA;48;2;12358;2348;14706
FAC0031336;2015-11-29;CLI00231;FACTURA;46;2;24613;4676;29289
FAC0031337;2015-01-05;CLI00855;FACTURA;44;2;341870;64955;406825
FAC0031338;2015-04-11;CLI00588;FACTURA;33;1;285080;54165;339245
FAC0031339;2015-01-07;CLI00322;FACTURA;10;1;50688;9631;60319
FAC0031340;2015-11-13;CLI00137;FACTURA;47;2;61700;11723;73423
FAC0031341;2015-12-19;CLI00913;FACTURA;26;2;56676;10768;67444
FAC0031342;2015-09-10;CLI00138;FACTURA;44;1;123066;23383;146449
FAC0031343;2015-06-30;CLI00040;FACTURA;25;1;56380;10712;67092
FAC0031344;2015-09-06;CLI00026;FACTURA;7;1;66122;12563;78685
FAC0031345;2015-10-09;CLI00349;FACTURA;43;2;54486;10352;64838
FAC0031346;2015-07-05;CLI00872;FACTURA;26;1;265830;50508;316338
FAC0031347;2015-03-27;CLI00565;FACTURA;46;2;75864;14414;90278
FAC0031348;2015-12-18;CLI00411;FACTURA;46;2;63568;12078;75646
FAC0031349;2015-12-22;CLI00960;FACTURA;38;1;56222;10682;66904
FAC0031350;2015-02-08;CLI00179;FACTURA;13;2;56898;10811;67709
FAC0031351;2015-03-20;CLI00234;FACTURA;20;1;117036;22237;139273
FAC0031352;2015-06-02;CLI00111;FACTURA;49;2;126582;24051;150633
FAC0031353;2015-07-07;CLI00485;FACTURA;35;2;195060;37061;232121
FAC0031354;2015-08-11;CLI00611;FACTURA;45;2;196731;37379;234110
FAC0031355;2015-04-08;CLI00920;FACTURA;40;1;83127;15794;98921
FAC0031356;2015-07-05;CLI00136;FACTURA;19;1;149870;28475;178345
FAC0031357;2015-10-10;CLI00241;FACTURA;49;2;6179;1174;7353
FAC0031358;2015-03-28;CLI00242;FACTURA;24;1;16035;3047;19082
FAC0031359;2015-10-07;CLI00812;FACTURA;11;1;30438;5783;36221
FAC0031360;2015-02-06;CLI00547;FACTURA;5;2;242970;46164;289134
FAC0031361;2015-02-23;CLI00799;FACTURA;29;2;273496;51964;325460
FAC0031362;2015-11-28;CLI00591;FACTURA;27;2;75568;14358;89926
FAC0031363;2015-03-21;CLI00690;FACTURA;11;1;84388;16034;100422
FAC0031364;2015-08-12;CLI00529;FACTURA;32;2;145015;27553;172568
FAC0031365;2015-10-04;CLI00439;FACTURA;41;2;335970;63834;399804
FAC0031366;2015-01-25;CLI00068;FACTURA;42;1;10146;1928;12074
FAC0031367;2015-05-15;CLI00267;FACTURA;30;2;22873;4346;27219
FAC0031368;2015-01-23;CLI00633;FACTURA;28;2;210970;40084;251054
FAC0031369;2015-12-01;CLI00816;FACTURA;39;1;23834;4528;28362
FAC0031370;2015-09-28;CLI00942;FACTURA;21;1;348040;66128;414168
FAC0031371;2015-09-30;CLI00317;FACTURA;29;2;35751;6793;42544
FAC0031372;2015-01-15;CLI00987;FACTURA;3;2;22206;4219;26425
FAC0031373;2015-09-23;CLI00642;FACTURA;28;1;39012;7412;46424
FAC0031374;2015-09-22;CLI00803;FACTURA;9;2;94485;17952;112437
FAC0031375;2015-02-06;CLI00934;FACTURA;42;1;109295;20766;130061
FAC0031376;2015-04-26;CLI00115;FACTURA;20;2;214100;40679;254779
FAC0031377;2015-09-08;CLI00852;FACTURA;36;1;91632;17410;109042
FAC0031378;2015-03-01;CLI00844;FACTURA;30;1;33844;6430;40274
FAC0031379;2015-10-09;CLI00487;FACTURA;8;2;122058;23191;145249
FAC0031380;2015-05-16;CLI00053;FACTURA;3;2;48105;9140;57245
FAC0031381;2015-09-05;CLI00975;FACTURA;45;2;221517;42088;263605
FAC0031382;2015-01-27;CLI00973;FACTURA;33;2;33828;6427;40255
FAC0031383;2015-10-12;CLI00894;FACTURA;20;1;30438;5783;36221
FAC0031384;2015-06-30;CLI00700;FACTURA;24;1;12340;2345;14685
FAC0031385;2015-05-24;CLI00460;FACTURA;37;1;205857;39113;244970
FAC0031386;2015-07-06;CLI00093;FACTURA;7;2;221517;42088;263605
FAC0031387;2015-03-28;CLI00499;FACTURA;4;2;100791;19150;119941
FAC0031388;2015-09-16;CLI00098;FACTURA;49;1;12358;2348;14706
FAC0031389;2015-06-17;CLI00224;FACTURA;49;1;51005;9691;60696
FAC0031390;2015-05-19;CLI00621;FACTURA;34;2;228730;43459;272189
FAC0031391;2015-12-16;CLI00376;FACTURA;46;1;56380;10712;67092
FAC0031392;2015-10-08;CLI00047;FACTURA;10;2;235179;44684;279863
FAC0031393;2015-11-16;CLI00619;FACTURA;27;2;84388;16034;100422
FAC0031394;2015-01-17;CLI00504;FACTURA;31;1;18510;3517;22027
FAC0031395;2015-09-20;CLI00632;FACTURA;13;1;94485;17952;112437
FAC0031396;2015-04-01;CLI00426;FACTURA;19;1;7946;1510;9456
FAC0031397;2015-06-24;CLI00294;FACTURA;39;1;26583;5051;31634
FAC0031398;2015-08-23;CLI00730;FACTURA;7;1;151788;28840;180628
FAC0031399;2015-12-24;CLI00334;FACTURA;5;1;25406;4827;30233
FAC0031400;2015-08-01;CLI00210;FACTURA;5;1;55530;10551;66081
FAC0031401;2015-09-07;CLI00609;FACTURA;41;2;144315;27420;171735
FAC0031402;2015-01-08;CLI00720;FACTURA;46;1;162426;30861;193287
FAC0031403;2015-05-27;CLI00349;FACTURA;3;2;218050;41430;259480
FAC0031404;2015-07-11;CLI00227;FACTURA;42;2;106332;20203;126535
FAC0031405;2015-01-21;CLI00716;FACTURA;8;1;20147;3828;23975
FAC0031406;2015-10-04;CLI00716;FACTURA;38;1;235179;44684;279863
FAC0031407;2015-10-20;CLI00299;FACTURA;44;2;76419;14520;90939
FAC0031408;2015-05-10;CLI00696;FACTURA;31;1;142401;27056;169457
FAC0031409;2015-06-16;CLI00624;FACTURA;7;1;105816;20105;125921
FAC0031410;2015-07-21;CLI00638;FACTURA;2;1;71502;13585;85087
FAC0031411;2015-01-27;CLI00631;FACTURA;41;2;112444;21364;133808
FAC0031412;2015-10-21;CLI00815;FACTURA;34;2;37074;7044;44118
FAC0031413;2015-08-01;CLI00316;FACTURA;31;1;174018;33063;207081
FAC0031414;2015-03-19;CLI00799;FACTURA;39;2;335970;63834;399804
FAC0031415;2015-04-05;CLI00980;FACTURA;32;1;66381;12612;78993
FAC0031416;2015-04-12;CLI00545;FACTURA;44;2;123452;23456;146908
FAC0031417;2015-05-24;CLI00478;FACTURA;18;1;127030;24136;151166
FAC0031418;2015-06-16;CLI00452;FACTURA;17;1;21859;4153;26012
FAC0031419;2015-07-02;CLI00454;FACTURA;15;1;239309;45469;284778
FAC0031420;2015-11-09;CLI00835;FACTURA;11;2;101715;19326;121041
FAC0031421;2015-11-06;CLI00192;FACTURA;23;1;189497;36004;225501
FAC0031422;2015-07-08;CLI00245;FACTURA;35;2;136740;25981;162721
FAC0031423;2015-12-22;CLI00312;FACTURA;24;1;196245;37287;233532
FAC0031424;2015-02-11;CLI00983;FACTURA;47;2;28190;5356;33546
FAC0031425;2015-01-12;CLI00270;FACTURA;28;1;221672;42118;263790
FAC0031426;2015-10-28;CLI00525;FACTURA;33;2;190701;36233;226934
FAC0031427;2015-06-10;CLI00785;FACTURA;10;2;162426;30861;193287
FAC0031428;2015-12-29;CLI00070;FACTURA;45;1;33792;6420;40212
FAC0031429;2015-07-12;CLI00629;FACTURA;12;2;109295;20766;130061
FAC0031430;2015-09-04;CLI00252;FACTURA;45;1;35751;6793;42544
FAC0031431;2015-05-27;CLI00416;FACTURA;17;1;189497;36004;225501
FAC0031432;2015-04-12;CLI00161;FACTURA;27;2;216568;41148;257716
FAC0031433;2015-01-19;CLI00594;FACTURA;48;1;10201;1938;12139
FAC0031434;2015-06-18;CLI00790;FACTURA;40;1;101532;19291;120823
FAC0031435;2015-10-31;CLI00065;FACTURA;43;2;64544;12263;76807
FAC0031436;2015-05-14;CLI00031;FACTURA;21;2;66381;12612;78993
FAC0031437;2015-05-26;CLI00260;FACTURA;5;1;127365;24199;151564
FAC0031438;2015-04-22;CLI00528;FACTURA;13;1;168666;32047;200713
FAC0031439;2015-08-03;CLI00328;FACTURA;23;1;98672;18748;117420
FAC0031440;2015-07-27;CLI00294;FACTURA;41;1;224888;42729;267617
FAC0031441;2015-06-26;CLI00791;FACTURA;43;2;57270;10881;68151
FAC0031442;2015-11-16;CLI00024;FACTURA;15;1;101624;19309;120933
FAC0031443;2015-06-30;CLI00335;FACTURA;37;2;341870;64955;406825
FAC0031444;2015-05-04;CLI00239;FACTURA;36;2;145224;27593;172817
FAC0031445;2015-10-27;CLI00287;FACTURA;49;2;84333;16023;100356
FAC0031446;2015-04-20;CLI00581;FACTURA;6;2;181112;34411;215523
FAC0031447;2015-12-30;CLI00184;FACTURA;36;1;142401;27056;169457
FAC0031448;2015-04-10;CLI00613;FACTURA;13;2;23838;4529;28367
FAC0031449;2015-05-11;CLI00547;FACTURA;31;2;80680;15329;96009
FAC0031450;2015-07-27;CLI00064;FACTURA;11;1;21859;4153;26012
FAC0031451;2015-12-06;CLI00523;FACTURA;43;2;28338;5384;33722
FAC0031452;2015-07-12;CLI00907;FACTURA;16;2;120882;22968;143850
FAC0031453;2015-04-18;CLI00107;FACTURA;33;2;100791;19150;119941
FAC0031454;2015-10-26;CLI00123;FACTURA;35;2;17636;3351;20987
FAC0031455;2015-12-03;CLI00214;FACTURA;45;1;171048;32499;203547
FAC0031456;2015-02-05;CLI00472;FACTURA;31;1;100735;19140;119875
FAC0031457;2015-03-11;CLI00899;FACTURA;15;2;108284;20574;128858
FAC0031458;2015-12-12;CLI00658;FACTURA;38;1;95336;18114;113450
FAC0031459;2015-05-23;CLI00831;FACTURA;46;2;67194;12767;79961
FAC0031460;2015-08-09;CLI00478;FACTURA;37;1;64544;12263;76807
FAC0031461;2015-05-30;CLI00499;FACTURA;35;2;81729;15529;97258
FAC0031462;2015-02-09;CLI00890;FACTURA;8;1;98672;18748;117420
FAC0031463;2015-07-15;CLI00995;FACTURA;38;2;218050;41430;259480
FAC0031464;2015-01-09;CLI00367;FACTURA;5;2;136740;25981;162721
FAC0031465;2015-01-25;CLI00939;FACTURA;14;2;34362;6529;40891
FAC0031466;2015-01-29;CLI00123;FACTURA;28;2;277090;52647;329737
FAC0031467;2015-09-08;CLI00193;FACTURA;22;2;104790;19910;124700
FAC0031468;2015-06-17;CLI00311;FACTURA;30;2;94311;17919;112230
FAC0031469;2015-05-26;CLI00260;FACTURA;43;1;98672;18748;117420
FAC0031470;2015-03-06;CLI00849;FACTURA;48;2;262128;49804;311932
FAC0031471;2015-12-27;CLI00956;FACTURA;7;1;229257;43559;272816
FAC0031472;2015-03-24;CLI00108;FACTURA;47;1;160111;30421;190532
FAC0031473;2015-07-27;CLI00366;FACTURA;4;1;98298;18677;116975
FAC0031474;2015-09-20;CLI00453;FACTURA;30;2;177648;33753;211401
FAC0031475;2015-11-18;CLI00083;FACTURA;2;2;170073;32314;202387
FAC0031476;2015-08-05;CLI00164;FACTURA;44;1;131064;24902;155966
FAC0031477;2015-06-17;CLI00069;FACTURA;1;2;177648;33753;211401
FAC0031478;2015-02-01;CLI00210;FACTURA;34;1;273496;51964;325460
FAC0031479;2015-05-01;CLI00612;FACTURA;32;1;348040;66128;414168
FAC0031480;2015-06-18;CLI00917;FACTURA;39;2;57016;10833;67849
FAC0031481;2015-12-09;CLI00710;FACTURA;32;1;18892;3589;22481
FAC0031482;2015-11-06;CLI00059;FACTURA;23;2;21805;4143;25948
FAC0031483;2015-11-08;CLI00282;FACTURA;25;1;90556;17206;107762
FAC0031484;2015-02-18;CLI00643;FACTURA;23;2;195060;37061;232121
FAC0031485;2015-02-07;CLI00640;FACTURA;34;1;262128;49804;311932
FAC0031486;2015-02-21;CLI00744;FACTURA;2;1;166254;31588;197842
FAC0031487;2015-01-30;CLI00187;FACTURA;8;2;313236;59515;372751
FAC0031488;2015-01-04;CLI00924;FACTURA;33;1;82044;15588;97632
FAC0031489;2015-03-03;CLI00772;FACTURA;18;1;183087;34787;217874
FAC0031490;2015-04-07;CLI00962;FACTURA;39;1;254060;48271;302331
FAC0031491;2015-09-25;CLI00207;FACTURA;24;2;166254;31588;197842
FAC0031492;2015-02-08;CLI00126;FACTURA;14;1;63568;12078;75646
FAC0031493;2015-10-23;CLI00110;FACTURA;1;1;21097;4008;25105
FAC0031494;2015-11-15;CLI00960;FACTURA;46;1;24680;4689;29369
FAC0031495;2015-02-02;CLI00564;FACTURA;40;1;90556;17206;107762
FAC0031496;2015-10-10;CLI00052;FACTURA;41;1;262128;49804;311932
FAC0031497;2015-01-21;CLI00767;FACTURA;36;2;143340;27235;170575
FAC0031498;2015-12-11;CLI00959;FACTURA;9;2;136740;25981;162721
FAC0031499;2015-01-28;CLI00643;FACTURA;10;2;53166;10102;63268
FAC0031500;2015-11-08;CLI00133;FACTURA;37;2;239309;45469;284778
FAC0031501;2015-05-16;CLI00970;FACTURA;18;1;84468;16049;100517
FAC0031502;2015-12-27;CLI00619;FACTURA;6;2;76419;14520;90939
FAC0031503;2015-04-17;CLI00948;FACTURA;29;1;112952;21461;134413
FAC0031504;2015-06-27;CLI00769;FACTURA;44;2;67917;12904;80821
FAC0031505;2015-08-04;CLI00412;FACTURA;4;1;221672;42118;263790
FAC0031506;2015-10-06;CLI00379;FACTURA;47;2;64230;12204;76434
FAC0031507;2015-05-01;CLI00731;FACTURA;39;2;116012;22042;138054
FAC0031508;2015-05-29;CLI00326;FACTURA;41;1;202384;38453;240837
FAC0031509;2015-08-24;CLI00416;FACTURA;35;1;18897;3590;22487
FAC0031510;2015-02-15;CLI00393;FACTURA;35;2;120882;22968;143850
FAC0031511;2015-07-15;CLI00069;FACTURA;12;2;39012;7412;46424
FAC0031512;2015-09-16;CLI00481;FACTURA;10;2;162744;30921;193665
FAC0031513;2015-05-09;CLI00214;FACTURA;10;1;58518;11118;69636
FAC0031514;2015-06-26;CLI00196;FACTURA;15;1;158473;30110;188583
FAC0031515;2015-10-14;CLI00361;FACTURA;3;2;67917;12904;80821
FAC0031516;2015-06-19;CLI00394;FACTURA;44;1;20402;3876;24278
FAC0031517;2015-03-19;CLI00378;FACTURA;22;1;26583;5051;31634
FAC0031518;2015-06-16;CLI00313;FACTURA;41;2;16922;3215;20137
FAC0031519;2015-10-31;CLI00983;FACTURA;11;2;98452;18706;117158
FAC0031520;2015-09-27;CLI00229;FACTURA;44;2;101624;19309;120933
FAC0031521;2015-02-10;CLI00906;FACTURA;46;1;15892;3019;18911
FAC0031522;2015-11-22;CLI00227;FACTURA;38;2;65577;12460;78037
FAC0031523;2015-12-24;CLI00839;FACTURA;9;2;21805;4143;25948
FAC0031524;2015-02-16;CLI00158;FACTURA;20;1;246130;46765;292895
FAC0031525;2015-10-18;CLI00505;FACTURA;44;2;80680;15329;96009
FAC0031526;2015-01-30;CLI00705;FACTURA;23;2;208260;39569;247829
FAC0031527;2015-11-12;CLI00903;FACTURA;47;2;101715;19326;121041
FAC0031528;2015-10-10;CLI00168;FACTURA;28;1;105816;20105;125921
FAC0031529;2015-10-16;CLI00111;FACTURA;10;2;80178;15234;95412
FAC0031530;2015-06-24;CLI00074;FACTURA;47;1;27071;5143;32214
FAC0031531;2015-12-06;CLI00821;FACTURA;50;2;169220;32152;201372
FAC0031532;2015-10-25;CLI00438;FACTURA;48;1;171280;32543;203823
FAC0031533;2015-06-18;CLI00392;FACTURA;23;1;24668;4687;29355
FAC0031534;2015-08-06;CLI00164;FACTURA;16;1;203430;38652;242082
FAC0031535;2015-08-29;CLI00512;FACTURA;6;1;216568;41148;257716
FAC0031536;2015-05-30;CLI00885;FACTURA;18;2;24668;4687;29355
FAC0031537;2015-03-23;CLI00495;FACTURA;43;2;205857;39113;244970
FAC0031538;2015-06-30;CLI00617;FACTURA;24;2;190701;36233;226934
FAC0031539;2015-11-22;CLI00989;FACTURA;39;2;290030;55106;345136
FAC0031540;2015-05-29;CLI00662;FACTURA;31;1;123340;23435;146775
FAC0031541;2015-08-15;CLI00538;FACTURA;42;1;10146;1928;12074
FAC0031542;2015-09-24;CLI00060;FACTURA;6;1;142401;27056;169457
FAC0031543;2015-12-04;CLI00275;FACTURA;26;2;136215;25881;162096
FAC0031544;2015-08-22;CLI00403;FACTURA;39;2;25344;4815;30159
FAC0031545;2015-07-03;CLI00331;FACTURA;41;2;139216;26451;165667
FAC0031546;2015-12-12;CLI00694;FACTURA;50;1;132279;25133;157412
FAC0031547;2015-06-30;CLI00299;FACTURA;7;2;21117;4012;25129
FAC0031548;2015-05-30;CLI00827;FACTURA;45;2;132279;25133;157412
FAC0031549;2015-04-08;CLI00088;FACTURA;20;1;7946;1510;9456
FAC0031550;2015-01-27;CLI00893;FACTURA;12;2;132279;25133;157412
FAC0031551;2015-07-16;CLI00676;FACTURA;1;1;35751;6793;42544
FAC0031552;2015-01-18;CLI00577;FACTURA;3;2;341870;64955;406825
FAC0031553;2015-08-22;CLI00668;FACTURA;28;1;118454;22506;140960
FAC0031554;2015-06-04;CLI00646;FACTURA;34;1;119170;22642;141812
FAC0031555;2015-10-07;CLI00338;FACTURA;40;1;66618;12657;79275
FAC0031556;2015-12-20;CLI00947;FACTURA;46;2;37074;7044;44118
FAC0031557;2015-10-22;CLI00770;FACTURA;4;1;101624;19309;120933
FAC0031558;2015-10-20;CLI00269;FACTURA;46;2;252999;48070;301069
FAC0031559;2015-01-26;CLI00773;FACTURA;14;2;120882;22968;143850
FAC0031560;2015-01-25;CLI00341;FACTURA;32;2;190053;36110;226163
FAC0031561;2015-02-05;CLI00381;FACTURA;28;2;168776;32067;200843
FAC0031562;2015-10-27;CLI00256;FACTURA;3;1;96210;18280;114490
FAC0031563;2015-03-18;CLI00942;FACTURA;27;1;73839;14029;87868
FAC0031564;2015-03-05;CLI00228;FACTURA;42;1;202384;38453;240837
FAC0031565;2015-05-16;CLI00832;FACTURA;2;1;81608;15506;97114
FAC0031566;2015-05-18;CLI00772;FACTURA;30;1;40584;7711;48295
FAC0031567;2015-06-24;CLI00468;FACTURA;2;1;82044;15588;97632
FAC0031568;2015-04-26;CLI00348;FACTURA;3;1;142540;27083;169623
FAC0031569;2015-03-21;CLI00525;FACTURA;40;2;181112;34411;215523
FAC0031570;2015-08-12;CLI00734;FACTURA;31;1;199854;37972;237826
FAC0031571;2015-08-07;CLI00778;FACTURA;29;1;133236;25315;158551
FAC0031572;2015-02-12;CLI00193;FACTURA;45;2;75894;14420;90314
FAC0031573;2015-06-04;CLI00231;FACTURA;1;2;205857;39113;244970
FAC0031574;2015-12-09;CLI00719;FACTURA;26;2;90556;17206;107762
FAC0031575;2015-05-11;CLI00762;FACTURA;36;1;110836;21059;131895
FAC0031576;2015-07-16;CLI00466;FACTURA;42;1;278432;52902;331334
FAC0031577;2015-09-24;CLI00327;FACTURA;38;2;109392;20784;130176
FAC0031578;2015-01-20;CLI00200;FACTURA;48;1;243639;46291;289930
FAC0031579;2015-11-12;CLI00888;FACTURA;40;1;59136;11236;70372
FAC0031580;2015-04-11;CLI00554;FACTURA;12;1;163830;31128;194958
FAC0031581;2015-12-29;CLI00557;FACTURA;37;2;290030;55106;345136
FAC0031582;2015-12-15;CLI00057;FACTURA;15;2;162426;30861;193287
FAC0031583;2015-12-23;CLI00474;FACTURA;21;1;7946;1510;9456
FAC0031584;2015-07-02;CLI00249;FACTURA;42;2;84468;16049;100517
FAC0031585;2015-02-08;CLI00336;FACTURA;26;1;211170;40122;251292
FAC0031586;2015-05-08;CLI00234;FACTURA;2;1;174440;33144;207584
FAC0031587;2015-08-31;CLI00875;FACTURA;4;2;50812;9654;60466
FAC0031588;2015-08-07;CLI00004;FACTURA;13;1;16914;3214;20128
FAC0031589;2015-03-10;CLI00235;FACTURA;35;2;273496;51964;325460
FAC0031590;2015-12-07;CLI00332;FACTURA;41;1;347100;65949;413049
FAC0031591;2015-10-31;CLI00327;FACTURA;9;2;27243;5176;32419
FAC0031592;2015-02-03;CLI00122;FACTURA;42;1;246680;46869;293549
FAC0031593;2015-03-30;CLI00360;FACTURA;16;1;262128;49804;311932
FAC0031594;2015-10-06;CLI00794;FACTURA;23;1;114365;21729;136094
FAC0031595;2015-12-19;CLI00984;FACTURA;36;1;21805;4143;25948
FAC0031596;2015-12-19;CLI00689;FACTURA;38;2;160350;30467;190817
FAC0031597;2015-01-08;CLI00213;FACTURA;13;2;18892;3589;22481
FAC0031598;2015-04-15;CLI00990;FACTURA;40;1;129088;24527;153615
FAC0031599;2015-10-01;CLI00990;FACTURA;29;1;59585;11321;70906
FAC0031600;2015-01-19;CLI00646;FACTURA;49;1;40804;7753;48557
FAC0031601;2015-09-12;CLI00356;FACTURA;23;1;307683;58460;366143
FAC0031602;2015-07-26;CLI00318;FACTURA;17;1;47230;8974;56204
FAC0031603;2015-09-25;CLI00836;FACTURA;38;1;18966;3604;22570
FAC0031604;2015-02-23;CLI00513;FACTURA;22;2;133236;25315;158551
FAC0031605;2015-03-02;CLI00665;FACTURA;27;2;175554;33355;208909
FAC0031606;2015-11-22;CLI00830;FACTURA;40;1;50688;9631;60319
FAC0031607;2015-01-15;CLI00457;FACTURA;11;2;161176;30623;191799
FAC0031608;2015-09-28;CLI00440;FACTURA;10;1;63291;12025;75316
FAC0031609;2015-07-15;CLI00259;FACTURA;17;2;50946;9680;60626
FAC0031610;2015-06-10;CLI00103;FACTURA;36;2;347100;65949;413049
FAC0031611;2015-02-06;CLI00781;FACTURA;45;2;76419;14520;90939
FAC0031612;2015-04-21;CLI00233;FACTURA;38;2;83832;15928;99760
FAC0031613;2015-05-06;CLI00225;FACTURA;44;2;166254;31588;197842
FAC0031614;2015-06-26;CLI00561;FACTURA;48;2;34362;6529;40891
FAC0031615;2015-02-18;CLI00637;FACTURA;29;2;94485;17952;112437
FAC0031616;2015-02-14;CLI00798;FACTURA;25;1;30850;5862;36712
FAC0031617;2015-02-16;CLI00633;FACTURA;15;2;37794;7181;44975
FAC0031618;2015-02-05;CLI00811;FACTURA;35;2;37784;7179;44963
FAC0031619;2015-11-22;CLI00370;FACTURA;7;1;17636;3351;20987
FAC0031620;2015-10-22;CLI00075;FACTURA;3;2;32272;6132;38404
FAC0031621;2015-05-13;CLI00364;FACTURA;18;1;50812;9654;60466
FAC0031622;2015-03-25;CLI00688;FACTURA;47;1;138545;26324;164869
FAC0031623;2015-08-30;CLI00051;FACTURA;6;2;201470;38279;239749
FAC0031624;2015-07-06;CLI00267;FACTURA;32;2;55611;10566;66177
FAC0031625;2015-12-03;CLI00449;FACTURA;33;2;132915;25254;158169
FAC0031626;2015-05-06;CLI00066;FACTURA;38;1;69420;13190;82610
FAC0031627;2015-07-15;CLI00614;FACTURA;1;1;94311;17919;112230
FAC0031628;2015-02-21;CLI00339;FACTURA;17;2;55530;10551;66081
FAC0031629;2015-02-07;CLI00271;FACTURA;23;2;87436;16613;104049
FAC0031630;2015-08-21;CLI00860;FACTURA;19;1;285080;54165;339245
FAC0031631;2015-02-24;CLI00680;FACTURA;42;1;104412;19838;124250
FAC0031632;2015-06-27;CLI00442;FACTURA;40;1;45278;8603;53881
FAC0031633;2015-02-17;CLI00391;FACTURA;46;2;29003;5511;34514
FAC0031634;2015-10-31;CLI00559;FACTURA;25;2;127365;24199;151564
FAC0031635;2015-10-09;CLI00792;FACTURA;8;1;192690;36611;229301
FAC0031636;2015-05-06;CLI00497;FACTURA;19;2;52395;9955;62350
FAC0031637;2015-07-23;CLI00816;FACTURA;19;1;81372;15461;96833
FAC0031638;2015-10-08;CLI00389;FACTURA;40;2;47668;9057;56725
FAC0031639;2015-09-08;CLI00644;FACTURA;2;1;172676;32808;205484
FAC0031640;2015-10-27;CLI00554;FACTURA;40;1;22908;4353;27261
FAC0031641;2015-07-11;CLI00476;FACTURA;25;1;67917;12904;80821
FAC0031642;2015-10-08;CLI00349;FACTURA;13;2;285080;54165;339245
FAC0031643;2015-12-16;CLI00709;FACTURA;10;2;68619;13038;81657
FAC0031644;2015-06-27;CLI00314;FACTURA;7;1;101715;19326;121041
FAC0031645;2015-04-14;CLI00975;FACTURA;5;2;107050;20340;127390
FAC0031646;2015-08-15;CLI00791;FACTURA;8;2;16922;3215;20137
FAC0031647;2015-10-20;CLI00008;FACTURA;41;1;181323;34451;215774
FAC0031648;2015-10-16;CLI00179;FACTURA;17;2;56222;10682;66904
FAC0031649;2015-12-25;CLI00497;FACTURA;45;2;101624;19309;120933
FAC0031650;2015-07-11;CLI00256;FACTURA;13;1;9446;1795;11241
FAC0031651;2015-02-19;CLI00038;FACTURA;44;1;82044;15588;97632
FAC0031652;2015-11-12;CLI00988;FACTURA;37;1;327660;62255;389915
FAC0031653;2015-01-17;CLI00213;FACTURA;39;2;45746;8692;54438
FAC0031654;2015-05-22;CLI00043;FACTURA;10;2;62874;11946;74820
FAC0031655;2015-12-04;CLI00973;FACTURA;35;2;22552;4285;26837
FAC0031656;2015-02-01;CLI00344;FACTURA;2;1;90556;17206;107762
FAC0031657;2015-01-26;CLI00661;FACTURA;15;2;160350;30467;190817
FAC0031658;2015-02-21;CLI00156;FACTURA;26;1;186081;35355;221436
FAC0031659;2015-12-23;CLI00885;FACTURA;50;2;64230;12204;76434
FAC0031660;2015-06-25;CLI00575;FACTURA;3;2;24613;4676;29289
FAC0031661;2015-07-15;CLI00567;FACTURA;30;2;41022;7794;48816
FAC0031662;2015-04-09;CLI00233;FACTURA;14;2;75894;14420;90314
FAC0031663;2015-06-06;CLI00885;FACTURA;50;2;71022;13494;84516
FAC0031664;2015-02-17;CLI00047;FACTURA;48;2;12340;2345;14685
FAC0031665;2015-08-23;CLI00517;FACTURA;31;2;28338;5384;33722
FAC0031666;2015-08-19;CLI00209;FACTURA;16;2;55418;10529;65947
FAC0031667;2015-09-10;CLI00900;FACTURA;43;1;76218;14481;90699
FAC0031668;2015-12-15;CLI00394;FACTURA;9;1;54486;10352;64838
FAC0031669;2015-11-25;CLI00348;FACTURA;13;1;80680;15329;96009
FAC0031670;2015-09-01;CLI00186;FACTURA;2;1;28668;5447;34115
FAC0031671;2015-01-27;CLI00449;FACTURA;27;2;190053;36110;226163
FAC0031672;2015-06-30;CLI00088;FACTURA;18;1;147819;28086;175905
FAC0031673;2015-07-10;CLI00765;FACTURA;24;2;9446;1795;11241
FAC0031674;2015-12-23;CLI00421;FACTURA;39;2;143340;27235;170575
FAC0031675;2015-10-15;CLI00321;FACTURA;31;2;246130;46765;292895
FAC0031676;2015-07-27;CLI00299;FACTURA;24;2;136740;25981;162721
FAC0031677;2015-02-20;CLI00542;FACTURA;27;1;88180;16754;104934
FAC0031678;2015-08-03;CLI00216;FACTURA;23;1;144315;27420;171735
FAC0031679;2015-12-11;CLI00136;FACTURA;48;1;116012;22042;138054
FAC0031680;2015-10-21;CLI00750;FACTURA;22;1;307683;58460;366143
FAC0031681;2015-11-04;CLI00573;FACTURA;44;2;145015;27553;172568
FAC0031682;2015-09-27;CLI00733;FACTURA;30;2;101192;19226;120418
FAC0031683;2015-12-11;CLI00712;FACTURA;19;1;32766;6226;38992
FAC0031684;2015-03-27;CLI00308;FACTURA;28;1;281110;53411;334521
FAC0031685;2015-04-23;CLI00120;FACTURA;34;1;114032;21666;135698
FAC0031686;2015-01-30;CLI00193;FACTURA;38;2;261027;49595;310622
FAC0031687;2015-04-10;CLI00927;FACTURA;39;2;245187;46586;291773
FAC0031688;2015-08-21;CLI00498;FACTURA;39;1;37932;7207;45139
FAC0031689;2015-01-12;CLI00630;FACTURA;26;1;192690;36611;229301
FAC0031690;2015-01-28;CLI00580;FACTURA;29;1;49336;9374;58710
FAC0031691;2015-05-05;CLI00733;FACTURA;8;2;67194;12767;79961
FAC0031692;2015-07-29;CLI00891;FACTURA;37;2;106332;20203;126535
FAC0031693;2015-12-28;CLI00494;FACTURA;31;1;285080;54165;339245
FAC0031694;2015-04-08;CLI00230;FACTURA;48;1;196596;37353;233949
FAC0031695;2015-10-16;CLI00334;FACTURA;49;1;100791;19150;119941
FAC0031696;2015-02-27;CLI00298;FACTURA;29;1;152838;29039;181877
FAC0031697;2015-03-07;CLI00118;FACTURA;25;1;222012;42182;264194
FAC0031698;2015-05-11;CLI00188;FACTURA;11;1;32272;6132;38404
FAC0031699;2015-05-05;CLI00663;FACTURA;18;2;262128;49804;311932
FAC0031700;2015-09-18;CLI00441;FACTURA;3;2;102010;19382;121392
FAC0031701;2015-07-02;CLI00998;FACTURA;20;1;327660;62255;389915
FAC0031702;2015-06-20;CLI00393;FACTURA;41;2;91492;17383;108875
FAC0031703;2015-07-19;CLI00201;FACTURA;25;2;9446;1795;11241
FAC0031704;2015-11-23;CLI00884;FACTURA;29;1;109025;20715;129740
FAC0031705;2015-12-25;CLI00261;FACTURA;15;2;42820;8136;50956
FAC0031706;2015-10-26;CLI00941;FACTURA;30;2;100338;19064;119402
FAC0031707;2015-12-24;CLI00495;FACTURA;36;2;145015;27553;172568
FAC0031708;2015-06-13;CLI00194;FACTURA;16;1;56691;10771;67462
FAC0031709;2015-01-18;CLI00023;FACTURA;47;2;222060;42191;264251
FAC0031710;2015-09-09;CLI00523;FACTURA;12;2;159498;30305;189803
FAC0031711;2015-10-19;CLI00297;FACTURA;43;2;183087;34787;217874
FAC0031712;2015-08-31;CLI00745;FACTURA;21;2;30895;5870;36765
FAC0031713;2015-12-28;CLI00922;FACTURA;33;1;59585;11321;70906
FAC0031714;2015-12-10;CLI00923;FACTURA;37;2;127030;24136;151166
FAC0031715;2015-11-23;CLI00519;FACTURA;42;2;30438;5783;36221
FAC0031716;2015-03-31;CLI00474;FACTURA;35;1;335970;63834;399804
FAC0031717;2015-10-13;CLI00210;FACTURA;32;1;50596;9613;60209
FAC0031718;2015-02-14;CLI00437;FACTURA;28;2;84480;16051;100531
FAC0031719;2015-07-03;CLI00586;FACTURA;4;1;156048;29649;185697
FAC0031720;2015-07-17;CLI00303;FACTURA;8;2;156048;29649;185697
FAC0031721;2015-05-13;CLI00690;FACTURA;35;1;265830;50508;316338
FAC0031722;2015-12-30;CLI00395;FACTURA;27;2;177842;33790;211632
FAC0031723;2015-10-18;CLI00739;FACTURA;2;2;136215;25881;162096
FAC0031724;2015-12-14;CLI00712;FACTURA;35;1;114365;21729;136094
FAC0031725;2015-12-09;CLI00170;FACTURA;6;1;163830;31128;194958
FAC0031726;2015-11-29;CLI00765;FACTURA;19;2;94460;17947;112407
FAC0031727;2015-04-13;CLI00045;FACTURA;21;2;168776;32067;200843
FAC0031728;2015-07-02;CLI00567;FACTURA;1;2;48408;9198;57606
FAC0031729;2015-06-25;CLI00961;FACTURA;13;2;159498;30305;189803
FAC0031730;2015-06-04;CLI00119;FACTURA;45;2;228064;43332;271396
FAC0031731;2015-07-10;CLI00560;FACTURA;10;1;81608;15506;97114
FAC0031732;2015-03-08;CLI00465;FACTURA;2;2;226390;43014;269404
FAC0031733;2015-01-31;CLI00103;FACTURA;48;2;76218;14481;90699
FAC0031734;2015-12-01;CLI00300;FACTURA;27;1;30438;5783;36221
FAC0031735;2015-10-19;CLI00691;FACTURA;16;2;12340;2345;14685
FAC0031736;2015-04-28;CLI00901;FACTURA;18;2;108284;20574;128858
FAC0031737;2015-01-30;CLI00743;FACTURA;42;2;24680;4689;29369
FAC0031738;2015-10-28;CLI00411;FACTURA;29;2;45746;8692;54438
FAC0031739;2015-08-25;CLI00454;FACTURA;33;1;10146;1928;12074
FAC0031740;2015-02-09;CLI00792;FACTURA;16;1;71407;13567;84974
FAC0031741;2015-08-01;CLI00084;FACTURA;39;1;81372;15461;96833
FAC0031742;2015-12-21;CLI00714;FACTURA;1;1;96210;18280;114490
FAC0031743;2015-06-27;CLI00535;FACTURA;24;2;43610;8286;51896
FAC0031744;2015-07-10;CLI00002;FACTURA;39;1;21097;4008;25105
FAC0031745;2015-04-19;CLI00084;FACTURA;11;1;127030;24136;151166
FAC0031746;2015-02-06;CLI00802;FACTURA;20;1;50596;9613;60209
FAC0031747;2015-12-04;CLI00766;FACTURA;7;1;50688;9631;60319
FAC0031748;2015-11-13;CLI00043;FACTURA;47;2;221672;42118;263790
FAC0031749;2015-07-08;CLI00283;FACTURA;50;2;22908;4353;27261
FAC0031750;2015-05-31;CLI00769;FACTURA;46;2;43718;8306;52024
FAC0031751;2015-06-19;CLI00839;FACTURA;47;2;246680;46869;293549
FAC0031752;2015-01-17;CLI00425;FACTURA;19;2;168936;32098;201034
FAC0031753;2015-07-29;CLI00666;FACTURA;25;1;74004;14061;88065
FAC0031754;2015-01-11;CLI00871;FACTURA;42;2;147819;28086;175905
FAC0031755;2015-10-30;CLI00827;FACTURA;42;2;174872;33226;208098
FAC0031756;2015-02-17;CLI00947;FACTURA;44;2;57270;10881;68151
FAC0031757;2015-06-23;CLI00994;FACTURA;31;1;22206;4219;26425
FAC0031758;2015-12-18;CLI00080;FACTURA;4;1;100791;19150;119941
FAC0031759;2015-11-24;CLI00347;FACTURA;28;2;24716;4696;29412
FAC0031760;2015-06-12;CLI00769;FACTURA;17;2;147819;28086;175905
FAC0031761;2015-09-16;CLI00850;FACTURA;29;1;156048;29649;185697
FAC0031762;2015-07-07;CLI00438;FACTURA;12;1;76218;14481;90699
FAC0031763;2015-08-03;CLI00550;FACTURA;20;1;25406;4827;30233
FAC0031764;2015-11-15;CLI00902;FACTURA;10;1;59136;11236;70372
FAC0031765;2015-06-24;CLI00953;FACTURA;39;2;41022;7794;48816
FAC0031766;2015-09-30;CLI00646;FACTURA;4;1;107050;20340;127390
FAC0031767;2015-05-16;CLI00981;FACTURA;25;2;114032;21666;135698
FAC0031768;2015-11-18;CLI00333;FACTURA;47;2;218590;41532;260122
FAC0031769;2015-11-14;CLI00137;FACTURA;30;2;228654;43444;272098
FAC0031770;2015-03-30;CLI00274;FACTURA;32;1;181112;34411;215523
FAC0031771;2015-07-22;CLI00194;FACTURA;24;1;33844;6430;40274
FAC0031772;2015-12-04;CLI00740;FACTURA;32;1;152838;29039;181877
FAC0031773;2015-10-29;CLI00656;FACTURA;19;1;21859;4153;26012
FAC0031774;2015-02-25;CLI00741;FACTURA;49;2;227682;43260;270942
FAC0031775;2015-05-23;CLI00264;FACTURA;15;1;119170;22642;141812
FAC0031776;2015-07-08;CLI00983;FACTURA;4;2;243628;46289;289917
FAC0031777;2015-06-09;CLI00031;FACTURA;34;2;160111;30421;190532
FAC0031778;2015-03-03;CLI00783;FACTURA;14;2;156048;29649;185697
FAC0031779;2015-07-28;CLI00223;FACTURA;24;2;158473;30110;188583
FAC0031780;2015-11-12;CLI00737;FACTURA;27;2;73353;13937;87290
FAC0031781;2015-06-10;CLI00107;FACTURA;22;2;98452;18706;117158
FAC0031782;2015-10-05;CLI00536;FACTURA;32;1;7946;1510;9456
FAC0031783;2015-02-24;CLI00114;FACTURA;48;1;66381;12612;78993
FAC0031784;2015-12-12;CLI00033;FACTURA;43;2;69420;13190;82610
FAC0031785;2015-02-18;CLI00307;FACTURA;38;2;75568;14358;89926
FAC0031786;2015-01-03;CLI00909;FACTURA;47;2;302373;57451;359824
FAC0031787;2015-06-01;CLI00234;FACTURA;11;1;24668;4687;29355
FAC0031788;2015-11-25;CLI00338;FACTURA;33;1;108284;20574;128858
FAC0031789;2015-02-26;CLI00925;FACTURA;39;2;285080;54165;339245
FAC0031790;2015-10-02;CLI00451;FACTURA;6;2;111030;21096;132126
FAC0031791;2015-01-07;CLI00363;FACTURA;5;2;127365;24199;151564
FAC0031792;2015-08-28;CLI00526;FACTURA;11;1;252980;48066;301046
FAC0031793;2015-09-16;CLI00536;FACTURA;30;1;205857;39113;244970
FAC0031794;2015-06-06;CLI00327;FACTURA;23;2;98672;18748;117420
FAC0031795;2015-07-27;CLI00924;FACTURA;8;1;302373;57451;359824
FAC0031796;2015-04-07;CLI00952;FACTURA;14;1;145224;27593;172817
FAC0031797;2015-03-10;CLI00229;FACTURA;14;2;37074;7044;44118
FAC0031798;2015-07-26;CLI00478;FACTURA;8;1;102561;19487;122048
FAC0031799;2015-04-19;CLI00160;FACTURA;10;1;85524;16250;101774
FAC0031800;2015-01-05;CLI00125;FACTURA;31;2;25344;4815;30159
FAC0031801;2015-06-05;CLI00230;FACTURA;44;1;226390;43014;269404
FAC0031802;2015-08-18;CLI00892;FACTURA;46;1;249381;47382;296763
FAC0031803;2015-06-22;CLI00001;FACTURA;47;2;83419;15850;99269
FAC0031804;2015-10-21;CLI00029;FACTURA;4;2;201470;38279;239749
FAC0031805;2015-09-27;CLI00844;FACTURA;49;1;138840;26380;165220
FAC0031806;2015-09-01;CLI00237;FACTURA;43;2;128280;24373;152653
FAC0031807;2015-05-07;CLI00670;FACTURA;1;1;148008;28122;176130
FAC0031808;2015-06-09;CLI00351;FACTURA;28;2;96210;18280;114490
FAC0031809;2015-01-06;CLI00060;FACTURA;18;1;45816;8705;54521
FAC0031810;2015-05-27;CLI00307;FACTURA;38;2;79460;15097;94557
FAC0031811;2015-08-09;CLI00955;FACTURA;37;2;114032;21666;135698
FAC0031812;2015-12-10;CLI00792;FACTURA;9;1;183087;34787;217874
FAC0031813;2015-12-02;CLI00023;FACTURA;11;2;278432;52902;331334
FAC0031814;2015-03-17;CLI00761;FACTURA;47;2;261027;49595;310622
FAC0031815;2015-06-18;CLI00860;FACTURA;14;1;174872;33226;208098
FAC0031816;2015-10-16;CLI00824;FACTURA;1;1;21859;4153;26012
FAC0031817;2015-07-02;CLI00277;FACTURA;43;2;126702;24073;150775
FAC0031818;2015-02-16;CLI00208;FACTURA;23;1;169220;32152;201372
FAC0031819;2015-04-22;CLI00888;FACTURA;23;1;50596;9613;60209
FAC0031820;2015-08-25;CLI00763;FACTURA;12;2;21117;4012;25129
FAC0031821;2015-12-06;CLI00221;FACTURA;4;2;45816;8705;54521
FAC0031822;2015-03-25;CLI00858;FACTURA;12;1;85524;16250;101774
FAC0031823;2015-07-25;CLI00995;FACTURA;21;2;40584;7711;48295
FAC0031824;2015-06-22;CLI00612;FACTURA;44;1;242970;46164;289134
FAC0031825;2015-10-12;CLI00583;FACTURA;2;2;24716;4696;29412
FAC0031826;2015-12-28;CLI00918;FACTURA;41;1;214100;40679;254779
FAC0031827;2015-02-06;CLI00848;FACTURA;25;1;11454;2176;13630
FAC0031828;2015-04-10;CLI00936;FACTURA;43;1;71022;13494;84516
FAC0031829;2015-02-23;CLI00655;FACTURA;47;2;65532;12451;77983
FAC0031830;2015-07-12;CLI00779;FACTURA;10;2;91492;17383;108875
FAC0031831;2015-05-06;CLI00979;FACTURA;34;2;145224;27593;172817
FAC0031832;2015-07-07;CLI00999;FACTURA;39;2;79460;15097;94557
FAC0031833;2015-03-21;CLI00511;FACTURA;25;2;101892;19359;121251
FAC0031834;2015-07-21;CLI00789;FACTURA;38;2;20343;3865;24208
FAC0031835;2015-03-18;CLI00601;FACTURA;48;2;30895;5870;36765
FAC0031836;2015-01-22;CLI00022;FACTURA;42;1;166254;31588;197842
FAC0031837;2015-01-26;CLI00027;FACTURA;31;2;327660;62255;389915
FAC0031838;2015-10-04;CLI00773;FACTURA;17;2;307683;58460;366143
FAC0031839;2015-02-28;CLI00719;FACTURA;18;2;100791;19150;119941
FAC0031840;2015-09-24;CLI00894;FACTURA;1;1;69420;13190;82610
FAC0031841;2015-01-03;CLI00440;FACTURA;46;1;68370;12990;81360
FAC0031842;2015-01-08;CLI00118;FACTURA;24;1;50742;9641;60383
FAC0031843;2015-08-27;CLI00900;FACTURA;40;1;67917;12904;80821
FAC0031844;2015-08-14;CLI00756;FACTURA;33;1;122058;23191;145249
FAC0031845;2015-11-28;CLI00251;FACTURA;9;2;152838;29039;181877
FAC0031846;2015-02-16;CLI00238;FACTURA;4;1;71670;13617;85287
FAC0031847;2015-07-24;CLI00109;FACTURA;22;2;152436;28963;181399
FAC0031848;2015-02-04;CLI00574;FACTURA;35;1;105585;20061;125646
FAC0031849;2015-02-13;CLI00426;FACTURA;38;1;55530;10551;66081
FAC0031850;2015-06-09;CLI00709;FACTURA;15;2;181112;34411;215523
FAC0031851;2015-05-07;CLI00701;FACTURA;41;2;86004;16341;102345
FAC0031852;2015-11-14;CLI00410;FACTURA;32;1;140555;26705;167260
FAC0031853;2015-09-07;CLI00558;FACTURA;15;1;27709;5265;32974
FAC0031854;2015-11-16;CLI00695;FACTURA;6;2;147819;28086;175905
FAC0031855;2015-02-21;CLI00400;FACTURA;40;1;142401;27056;169457
FAC0031856;2015-05-06;CLI00019;FACTURA;22;2;32766;6226;38992
FAC0031857;2015-11-10;CLI00144;FACTURA;23;1;54486;10352;64838
FAC0031858;2015-12-16;CLI00154;FACTURA;30;1;81213;15430;96643
FAC0031859;2015-07-20;CLI00249;FACTURA;2;2;96210;18280;114490
FAC0031860;2015-10-07;CLI00912;FACTURA;21;1;49360;9378;58738
FAC0031861;2015-09-04;CLI00740;FACTURA;37;1;208824;39677;248501
FAC0031862;2015-08-15;CLI00230;FACTURA;15;1;59585;11321;70906
FAC0031863;2015-06-08;CLI00092;FACTURA;38;1;123066;23383;146449
FAC0031864;2015-09-09;CLI00411;FACTURA;32;2;5638;1071;6709
FAC0031865;2015-04-03;CLI00112;FACTURA;10;1;130830;24858;155688
FAC0031866;2015-10-12;CLI00902;FACTURA;25;1;239309;45469;284778
FAC0031867;2015-02-03;CLI00319;FACTURA;4;2;9446;1795;11241
FAC0031868;2015-04-23;CLI00922;FACTURA;40;1;21859;4153;26012
FAC0031869;2015-06-08;CLI00445;FACTURA;25;2;81729;15529;97258
FAC0031870;2015-03-23;CLI00415;FACTURA;37;2;127365;24199;151564
FAC0031871;2015-10-09;CLI00744;FACTURA;1;1;196731;37379;234110
FAC0031872;2015-06-10;CLI00549;FACTURA;15;2;246130;46765;292895
FAC0031873;2015-05-02;CLI00408;FACTURA;14;1;113195;21507;134702
FAC0031874;2015-05-11;CLI00962;FACTURA;31;1;20292;3855;24147
FAC0031875;2015-03-03;CLI00357;FACTURA;21;2;47230;8974;56204
FAC0031876;2015-10-27;CLI00346;FACTURA;7;1;101192;19226;120418
FAC0031877;2015-08-03;CLI00283;FACTURA;50;2;63351;12037;75388
FAC0031878;2015-01-16;CLI00258;FACTURA;15;1;208260;39569;247829
FAC0031879;2015-03-02;CLI00716;FACTURA;31;1;58006;11021;69027
FAC0031880;2015-03-10;CLI00891;FACTURA;15;2;138840;26380;165220
FAC0031881;2015-11-13;CLI00546;FACTURA;47;1;152436;28963;181399
FAC0031882;2015-02-15;CLI00803;FACTURA;28;2;268776;51067;319843
FAC0031883;2015-12-11;CLI00082;FACTURA;9;1;144315;27420;171735
FAC0031884;2015-02-03;CLI00166;FACTURA;22;1;117036;22237;139273
FAC0031885;2015-11-07;CLI00836;FACTURA;4;1;101892;19359;121251
FAC0031886;2015-10-28;CLI00590;FACTURA;24;1;76419;14520;90939
FAC0031887;2015-07-13;CLI00848;FACTURA;21;1;65577;12460;78037
FAC0031888;2015-01-23;CLI00348;FACTURA;5;1;196777;37388;234165
FAC0031889;2015-10-25;CLI00279;FACTURA;34;2;32070;6093;38163
FAC0031890;2015-07-11;CLI00574;FACTURA;32;1;58006;11021;69027
FAC0031891;2015-07-10;CLI00849;FACTURA;26;2;94830;18018;112848
FAC0031892;2015-11-20;CLI00568;FACTURA;15;1;98452;18706;117158
FAC0031893;2015-02-09;CLI00701;FACTURA;29;2;62874;11946;74820
FAC0031894;2015-04-29;CLI00597;FACTURA;41;2;163830;31128;194958
FAC0031895;2015-10-22;CLI00290;FACTURA;40;1;78024;14825;92849
FAC0031896;2015-05-04;CLI00997;FACTURA;42;2;18510;3517;22027
FAC0031897;2015-12-17;CLI00315;FACTURA;8;2;127365;24199;151564
FAC0031898;2015-01-03;CLI00906;FACTURA;5;1;39012;7412;46424
FAC0031899;2015-11-22;CLI00788;FACTURA;46;1;58006;11021;69027
FAC0031900;2015-07-27;CLI00085;FACTURA;12;2;341870;64955;406825
FAC0031901;2015-03-16;CLI00425;FACTURA;22;2;132915;25254;158169
FAC0031902;2015-02-27;CLI00439;FACTURA;21;2;83419;15850;99269
FAC0031903;2015-11-03;CLI00109;FACTURA;15;2;123452;23456;146908
FAC0031904;2015-04-11;CLI00301;FACTURA;50;2;67194;12767;79961
FAC0031905;2015-06-17;CLI00310;FACTURA;49;1;100735;19140;119875
FAC0031906;2015-10-27;CLI00435;FACTURA;16;2;79460;15097;94557
FAC0031907;2015-05-24;CLI00180;FACTURA;47;1;126702;24073;150775
FAC0031908;2015-04-23;CLI00091;FACTURA;13;2;170073;32314;202387
FAC0031909;2015-11-02;CLI00679;FACTURA;1;2;47668;9057;56725
FAC0031910;2015-11-29;CLI00356;FACTURA;7;1;134388;25534;159922
FAC0031911;2015-07-04;CLI00429;FACTURA;15;2;37784;7179;44963
FAC0031912;2015-12-21;CLI00089;FACTURA;42;2;101460;19277;120737
FAC0031913;2015-01-24;CLI00251;FACTURA;1;2;80588;15312;95900
FAC0031914;2015-10-12;CLI00036;FACTURA;14;1;49336;9374;58710
FAC0031915;2015-11-18;CLI00421;FACTURA;8;2;262128;49804;311932
FAC0031916;2015-04-01;CLI00522;FACTURA;50;1;270710;51435;322145
FAC0031917;2015-02-27;CLI00528;FACTURA;44;1;55622;10568;66190
FAC0031918;2015-07-29;CLI00859;FACTURA;46;2;205857;39113;244970
FAC0031919;2015-03-01;CLI00367;FACTURA;13;2;245187;46586;291773
FAC0031920;2015-06-09;CLI00598;FACTURA;48;1;50766;9646;60412
FAC0031921;2015-01-20;CLI00276;FACTURA;14;1;181323;34451;215774
FAC0031922;2015-02-11;CLI00903;FACTURA;33;2;91809;17444;109253
FAC0031923;2015-12-07;CLI00643;FACTURA;7;2;136748;25982;162730
FAC0031924;2015-12-14;CLI00397;FACTURA;43;2;173550;32975;206525
FAC0031925;2015-12-02;CLI00167;FACTURA;34;2;142540;27083;169623
FAC0031926;2015-04-06;CLI00136;FACTURA;31;1;341870;64955;406825
FAC0031927;2015-04-20;CLI00893;FACTURA;29;2;170073;32314;202387
FAC0031928;2015-03-28;CLI00675;FACTURA;29;2;20958;3982;24940
FAC0031929;2015-03-13;CLI00120;FACTURA;41;1;193963;36853;230816
FAC0031930;2015-01-08;CLI00065;FACTURA;35;2;62874;11946;74820
FAC0031931;2015-02-08;CLI00465;FACTURA;19;2;18966;3604;22570
FAC0031932;2015-06-30;CLI00903;FACTURA;39;2;262128;49804;311932
FAC0031933;2015-12-02;CLI00439;FACTURA;27;2;239309;45469;284778
FAC0031934;2015-05-13;CLI00728;FACTURA;27;1;49226;9353;58579
FAC0031935;2015-01-07;CLI00597;FACTURA;12;2;16922;3215;20137
FAC0031936;2015-09-03;CLI00931;FACTURA;10;2;228064;43332;271396
FAC0031937;2015-11-01;CLI00912;FACTURA;30;1;28111;5341;33452
FAC0031938;2015-05-27;CLI00494;FACTURA;24;1;22552;4285;26837
FAC0031939;2015-06-25;CLI00398;FACTURA;50;1;229257;43559;272816
FAC0031940;2015-01-13;CLI00188;FACTURA;50;1;190701;36233;226934
FAC0031941;2015-12-08;CLI00511;FACTURA;3;2;23838;4529;28367
FAC0031942;2015-12-11;CLI00731;FACTURA;43;2;108284;20574;128858
FAC0031943;2015-05-01;CLI00225;FACTURA;39;2;174018;33063;207081
FAC0031944;2015-08-02;CLI00823;FACTURA;22;2;108972;20705;129677
FAC0031945;2015-05-10;CLI00333;FACTURA;39;2;23834;4528;28362
FAC0031946;2015-12-02;CLI00415;FACTURA;21;2;221672;42118;263790
FAC0031947;2015-04-18;CLI00895;FACTURA;6;2;23838;4529;28367
FAC0031948;2015-07-31;CLI00559;FACTURA;50;2;84480;16051;100531
FAC0031949;2015-06-02;CLI00725;FACTURA;23;2;221672;42118;263790
FAC0031950;2015-08-24;CLI00480;FACTURA;48;1;197344;37495;234839
FAC0031951;2015-02-03;CLI00480;FACTURA;29;1;84333;16023;100356
FAC0031952;2015-07-11;CLI00759;FACTURA;26;2;30895;5870;36765
FAC0031953;2015-12-29;CLI00355;FACTURA;12;2;249381;47382;296763
FAC0031954;2015-01-02;CLI00642;FACTURA;15;1;98298;18677;116975
FAC0031955;2015-07-27;CLI00666;FACTURA;17;1;128460;24407;152867
FAC0031956;2015-12-06;CLI00253;FACTURA;44;2;65532;12451;77983
FAC0031957;2015-04-22;CLI00968;FACTURA;25;1;30603;5815;36418
FAC0031958;2015-09-04;CLI00774;FACTURA;5;1;20343;3865;24208
FAC0031959;2015-06-27;CLI00027;FACTURA;27;2;48105;9140;57245
FAC0031960;2015-02-08;CLI00193;FACTURA;15;2;31784;6039;37823
FAC0031961;2015-04-19;CLI00659;FACTURA;17;2;33844;6430;40274
FAC0031962;2015-03-23;CLI00706;FACTURA;7;1;104412;19838;124250
FAC0031963;2015-04-15;CLI00247;FACTURA;42;2;50766;9646;60412
FAC0031964;2015-11-24;CLI00251;FACTURA;41;2;199556;37916;237472
FAC0031965;2015-07-18;CLI00446;FACTURA;25;1;69420;13190;82610
FAC0031966;2015-02-16;CLI00755;FACTURA;48;2;170935;32478;203413
FAC0031967;2015-01-18;CLI00498;FACTURA;14;1;25473;4840;30313
FAC0031968;2015-07-31;CLI00309;FACTURA;15;2;43718;8306;52024
FAC0031969;2015-06-14;CLI00318;FACTURA;36;1;160111;30421;190532
FAC0031970;2015-06-06;CLI00670;FACTURA;25;1;73353;13937;87290
FAC0031971;2015-07-12;CLI00285;FACTURA;42;2;158724;30158;188882
FAC0031972;2015-09-03;CLI00859;FACTURA;8;2;19506;3706;23212
FAC0031973;2015-04-22;CLI00602;FACTURA;38;1;71502;13585;85087
FAC0031974;2015-11-21;CLI00432;FACTURA;24;1;130830;24858;155688
FAC0031975;2015-06-08;CLI00238;FACTURA;35;1;123065;23382;146447
FAC0031976;2015-01-10;CLI00869;FACTURA;35;2;278432;52902;331334
FAC0031977;2015-05-28;CLI00176;FACTURA;41;1;147678;28059;175737
FAC0031978;2015-05-15;CLI00408;FACTURA;34;1;22873;4346;27219
FAC0031979;2015-12-15;CLI00680;FACTURA;15;1;114672;21788;136460
FAC0031980;2015-11-11;CLI00776;FACTURA;44;1;13674;2598;16272
FAC0031981;2015-09-15;CLI00416;FACTURA;44;1;20402;3876;24278
FAC0031982;2015-02-15;CLI00587;FACTURA;35;2;239247;45457;284704
FAC0031983;2015-09-23;CLI00908;FACTURA;48;1;137238;26075;163313
FAC0031984;2015-10-11;CLI00540;FACTURA;46;1;216568;41148;257716
FAC0031985;2015-11-19;CLI00418;FACTURA;20;1;24668;4687;29355
FAC0031986;2015-11-27;CLI00818;FACTURA;49;1;181112;34411;215523
FAC0031987;2015-02-15;CLI00396;FACTURA;25;1;243639;46291;289930
FAC0031988;2015-05-23;CLI00626;FACTURA;32;1;52908;10053;62961
FAC0031989;2015-03-09;CLI00663;FACTURA;7;2;80680;15329;96009
FAC0031990;2015-12-22;CLI00575;FACTURA;6;2;114032;21666;135698
FAC0031991;2015-10-29;CLI00489;FACTURA;17;2;100735;19140;119875
FAC0031992;2015-04-10;CLI00065;FACTURA;7;2;163830;31128;194958
FAC0031993;2015-07-12;CLI00626;FACTURA;18;1;57016;10833;67849
FAC0031994;2015-11-19;CLI00813;FACTURA;15;2;203751;38713;242464
FAC0031995;2015-04-13;CLI00552;FACTURA;24;1;71022;13494;84516
FAC0031996;2015-08-29;CLI00971;FACTURA;32;2;246680;46869;293549
FAC0031997;2015-12-31;CLI00716;FACTURA;44;1;81372;15461;96833
FAC0031998;2015-05-30;CLI00266;FACTURA;4;1;60441;11484;71925
FAC0031999;2015-02-11;CLI00071;FACTURA;1;2;47668;9057;56725
FAC0032000;2015-05-07;CLI00558;FACTURA;41;1;67584;12841;80425
FAC0032001;2015-08-04;CLI00608;FACTURA;13;1;67194;12767;79961
FAC0032002;2015-04-26;CLI00479;FACTURA;48;2;188970;35904;224874
FAC0032003;2015-05-26;CLI00323;FACTURA;16;2;162744;30921;193665
FAC0032004;2015-04-30;CLI00260;FACTURA;10;1;71670;13617;85287
FAC0032005;2015-10-16;CLI00537;FACTURA;16;2;123452;23456;146908
FAC0032006;2015-09-16;CLI00464;FACTURA;35;1;9446;1795;11241
FAC0032007;2015-05-10;CLI00326;FACTURA;50;1;56691;10771;67462
FAC0032008;2015-08-29;CLI00523;FACTURA;1;2;33828;6427;40255
FAC0032009;2015-06-27;CLI00063;FACTURA;40;2;20147;3828;23975
FAC0032010;2015-08-14;CLI00466;FACTURA;7;1;30850;5862;36712
FAC0032011;2015-12-05;CLI00384;FACTURA;34;1;61790;11740;73530
FAC0032012;2015-09-15;CLI00579;FACTURA;16;2;41022;7794;48816
FAC0032013;2015-03-28;CLI00722;FACTURA;14;1;285080;54165;339245
FAC0032014;2015-12-20;CLI00342;FACTURA;19;1;61029;11596;72625
FAC0032015;2015-08-15;CLI00314;FACTURA;50;1;28508;5417;33925
FAC0032016;2015-03-07;CLI00027;FACTURA;8;2;67584;12841;80425
FAC0032017;2015-11-20;CLI00833;FACTURA;32;2;58518;11118;69636
FAC0032018;2015-01-25;CLI00225;FACTURA;48;2;17636;3351;20987
FAC0032019;2015-09-06;CLI00958;FACTURA;29;1;96816;18395;115211
FAC0032020;2015-08-17;CLI00008;FACTURA;50;1;128460;24407;152867
FAC0032021;2015-01-18;CLI00150;FACTURA;36;1;132915;25254;158169
FAC0032022;2015-11-11;CLI00440;FACTURA;6;1;105585;20061;125646
FAC0032023;2015-01-08;CLI00391;FACTURA;16;2;16035;3047;19082
FAC0032024;2015-07-18;CLI00285;FACTURA;45;2;120882;22968;143850
FAC0032025;2015-10-19;CLI00970;FACTURA;22;1;68374;12991;81365
FAC0032026;2015-02-15;CLI00255;FACTURA;49;2;35751;6793;42544
FAC0032027;2015-01-07;CLI00683;FACTURA;35;2;108972;20705;129677
FAC0032028;2015-08-20;CLI00579;FACTURA;33;2;30438;5783;36221
FAC0032029;2015-11-26;CLI00733;FACTURA;46;2;114540;21763;136303
FAC0032030;2015-12-12;CLI00041;FACTURA;43;2;37784;7179;44963
FAC0032031;2015-05-09;CLI00196;FACTURA;4;1;167985;31917;199902
FAC0032032;2015-01-23;CLI00357;FACTURA;16;2;58518;11118;69636
FAC0032033;2015-08-29;CLI00513;FACTURA;5;2;105585;20061;125646
FAC0032034;2015-08-06;CLI00882;FACTURA;31;1;277090;52647;329737
FAC0032035;2015-02-02;CLI00767;FACTURA;9;2;135376;25721;161097
FAC0032036;2015-01-16;CLI00841;FACTURA;20;2;203021;38574;241595
FAC0032037;2015-03-14;CLI00143;FACTURA;12;2;83127;15794;98921
FAC0032038;2015-01-05;CLI00605;FACTURA;26;2;114365;21729;136094
FAC0032039;2015-09-24;CLI00870;FACTURA;11;1;176360;33508;209868
FAC0032040;2015-08-24;CLI00785;FACTURA;32;2;138840;26380;165220
FAC0032041;2015-12-21;CLI00493;FACTURA;11;2;166254;31588;197842
FAC0032042;2015-12-27;CLI00483;FACTURA;16;2;16922;3215;20137
FAC0032043;2015-04-17;CLI00208;FACTURA;19;1;18897;3590;22487
FAC0032044;2015-10-23;CLI00754;FACTURA;2;1;166254;31588;197842
FAC0032045;2015-09-21;CLI00490;FACTURA;12;1;235179;44684;279863
FAC0032046;2015-05-06;CLI00575;FACTURA;29;2;47415;9009;56424
FAC0032047;2015-12-14;CLI00441;FACTURA;32;2;128280;24373;152653
FAC0032048;2015-11-02;CLI00791;FACTURA;49;2;118454;22506;140960
FAC0032049;2015-11-01;CLI00045;FACTURA;10;2;67688;12861;80549
FAC0032050;2015-05-06;CLI00882;FACTURA;12;1;56380;10712;67092
FAC0032051;2015-12-30;CLI00393;FACTURA;3;2;55530;10551;66081
FAC0032052;2015-05-11;CLI00147;FACTURA;14;2;113195;21507;134702
FAC0032053;2015-11-25;CLI00305;FACTURA;1;2;278432;52902;331334
FAC0032054;2015-10-04;CLI00525;FACTURA;37;2;254730;48399;303129
FAC0032055;2015-02-21;CLI00986;FACTURA;33;1;88824;16877;105701
FAC0032056;2015-06-12;CLI00331;FACTURA;29;2;32766;6226;38992
FAC0032057;2015-03-21;CLI00062;FACTURA;18;1;138840;26380;165220
FAC0032058;2015-05-29;CLI00437;FACTURA;27;2;129006;24511;153517
FAC0032059;2015-02-26;CLI00344;FACTURA;44;1;177842;33790;211632
FAC0032060;2015-12-29;CLI00717;FACTURA;39;2;143340;27235;170575
FAC0032061;2015-02-15;CLI00363;FACTURA;22;2;25344;4815;30159
FAC0032062;2015-05-30;CLI00611;FACTURA;49;2;56691;10771;67462
FAC0032063;2015-04-27;CLI00898;FACTURA;4;1;183087;34787;217874
FAC0032064;2015-07-07;CLI00305;FACTURA;3;2;221672;42118;263790
FAC0032065;2015-06-18;CLI00417;FACTURA;18;2;16896;3210;20106
FAC0032066;2015-10-27;CLI00693;FACTURA;13;2;196731;37379;234110
FAC0032067;2015-07-22;CLI00866;FACTURA;2;1;228654;43444;272098
FAC0032068;2015-02-28;CLI00665;FACTURA;26;2;252999;48070;301069
FAC0032069;2015-04-06;CLI00065;FACTURA;37;2;104130;19785;123915
FAC0032070;2015-11-15;CLI00601;FACTURA;45;2;21805;4143;25948
FAC0032071;2015-07-11;CLI00949;FACTURA;12;2;139216;26451;165667
FAC0032072;2015-03-17;CLI00889;FACTURA;13;2;171048;32499;203547
FAC0032073;2015-01-20;CLI00855;FACTURA;36;2;122058;23191;145249
FAC0032074;2015-05-10;CLI00596;FACTURA;50;1;67194;12767;79961
FAC0032075;2015-12-06;CLI00702;FACTURA;33;1;104412;19838;124250
FAC0032076;2015-08-17;CLI00350;FACTURA;44;1;11276;2142;13418
FAC0032077;2015-03-25;CLI00446;FACTURA;50;1;52395;9955;62350
FAC0032078;2015-10-01;CLI00677;FACTURA;17;2;24716;4696;29412
FAC0032079;2015-05-23;CLI00864;FACTURA;7;1;24716;4696;29412
FAC0032080;2015-09-06;CLI00715;FACTURA;2;2;34804;6613;41417
FAC0032081;2015-03-25;CLI00368;FACTURA;14;1;66618;12657;79275
FAC0032082;2015-01-21;CLI00108;FACTURA;32;1;96816;18395;115211
FAC0032083;2015-11-15;CLI00959;FACTURA;39;2;42240;8026;50266
FAC0032084;2015-10-10;CLI00318;FACTURA;19;1;81168;15422;96590
FAC0032085;2015-10-05;CLI00601;FACTURA;24;2;86004;16341;102345
FAC0032086;2015-11-16;CLI00345;FACTURA;35;2;162426;30861;193287
FAC0032087;2015-08-05;CLI00042;FACTURA;14;1;47230;8974;56204
FAC0032088;2015-10-05;CLI00246;FACTURA;29;1;23838;4529;28367
FAC0032089;2015-06-13;CLI00049;FACTURA;21;2;145224;27593;172817
FAC0032090;2015-11-04;CLI00181;FACTURA;31;2;20147;3828;23975
FAC0032091;2015-11-08;CLI00486;FACTURA;11;1;114365;21729;136094
FAC0032092;2015-12-21;CLI00569;FACTURA;38;2;11454;2176;13630
FAC0032093;2015-12-14;CLI00346;FACTURA;45;1;20343;3865;24208
FAC0032094;2015-09-22;CLI00222;FACTURA;27;1;28668;5447;34115
FAC0032095;2015-03-12;CLI00959;FACTURA;25;2;41022;7794;48816
FAC0032096;2015-12-11;CLI00942;FACTURA;6;1;108284;20574;128858
FAC0032097;2015-04-07;CLI00514;FACTURA;15;1;96210;18280;114490
FAC0032098;2015-08-24;CLI00811;FACTURA;30;2;35272;6702;41974
FAC0032099;2015-05-15;CLI00418;FACTURA;38;1;34710;6595;41305
FAC0032100;2015-01-08;CLI00045;FACTURA;29;2;170073;32314;202387
FAC0032101;2015-03-18;CLI00954;FACTURA;12;1;54142;10287;64429
FAC0032102;2015-07-08;CLI00818;FACTURA;25;1;211170;40122;251292
FAC0032103;2015-12-11;CLI00021;FACTURA;13;2;42194;8017;50211
FAC0032104;2015-12-04;CLI00799;FACTURA;44;2;12358;2348;14706
FAC0032105;2015-12-30;CLI00165;FACTURA;26;2;243628;46289;289917
FAC0032106;2015-10-29;CLI00885;FACTURA;38;2;90556;17206;107762
FAC0032107;2015-05-24;CLI00765;FACTURA;15;2;129006;24511;153517
FAC0032108;2015-10-20;CLI00541;FACTURA;8;2;84468;16049;100517
FAC0032109;2015-03-02;CLI00862;FACTURA;26;1;136740;25981;162721
FAC0032110;2015-04-19;CLI00234;FACTURA;12;1;109295;20766;130061
FAC0032111;2015-05-23;CLI00886;FACTURA;21;1;181323;34451;215774
FAC0032112;2015-07-02;CLI00416;FACTURA;41;1;97530;18531;116061
FAC0032113;2015-07-07;CLI00717;FACTURA;40;2;162744;30921;193665
FAC0032114;2015-02-19;CLI00673;FACTURA;38;2;75568;14358;89926
FAC0032115;2015-08-01;CLI00812;FACTURA;37;1;136215;25881;162096
FAC0032116;2015-06-09;CLI00390;FACTURA;25;1;55418;10529;65947
FAC0032117;2015-03-22;CLI00677;FACTURA;16;2;80178;15234;95412
FAC0032118;2015-11-14;CLI00309;FACTURA;1;2;64544;12263;76807
FAC0032119;2015-08-14;CLI00864;FACTURA;10;1;22908;4353;27261
FAC0032120;2015-07-07;CLI00021;FACTURA;22;2;50812;9654;60466
FAC0032121;2015-07-01;CLI00927;FACTURA;36;2;67917;12904;80821
FAC0032122;2015-04-03;CLI00600;FACTURA;2;1;221672;42118;263790
FAC0032123;2015-04-10;CLI00248;FACTURA;11;1;158724;30158;188882
FAC0032124;2015-07-07;CLI00566;FACTURA;4;1;218590;41532;260122
FAC0032125;2015-09-22;CLI00174;FACTURA;49;1;40686;7730;48416
FAC0032126;2015-08-01;CLI00261;FACTURA;40;2;114672;21788;136460
FAC0032127;2015-05-02;CLI00065;FACTURA;8;2;205857;39113;244970
FAC0032128;2015-05-06;CLI00671;FACTURA;48;2;81168;15422;96590
FAC0032129;2015-11-16;CLI00520;FACTURA;24;1;108284;20574;128858
FAC0032130;2015-05-13;CLI00537;FACTURA;32;2;35751;6793;42544
FAC0032131;2015-07-03;CLI00514;FACTURA;32;1;76032;14446;90478
FAC0032132;2015-08-11;CLI00157;FACTURA;39;2;25298;4807;30105
FAC0032133;2015-07-24;CLI00201;FACTURA;16;2;75568;14358;89926
FAC0032134;2015-12-10;CLI00613;FACTURA;43;2;161176;30623;191799
FAC0032135;2015-07-30;CLI00138;FACTURA;11;1;171048;32499;203547
FAC0032136;2015-04-30;CLI00459;FACTURA;28;2;226390;43014;269404
FAC0032137;2015-01-27;CLI00740;FACTURA;22;1;172676;32808;205484
FAC0032138;2015-06-30;CLI00691;FACTURA;28;2;141029;26796;167825
FAC0032139;2015-11-27;CLI00015;FACTURA;37;2;205857;39113;244970
FAC0032140;2015-04-09;CLI00723;FACTURA;16;2;45746;8692;54438
FAC0032141;2015-07-04;CLI00653;FACTURA;8;2;131154;24919;156073
FAC0032142;2015-05-22;CLI00335;FACTURA;48;2;98298;18677;116975
FAC0032143;2015-10-19;CLI00564;FACTURA;41;1;174020;33064;207084
FAC0032144;2015-02-20;CLI00814;FACTURA;9;1;41916;7964;49880
FAC0032145;2015-08-26;CLI00971;FACTURA;17;2;30895;5870;36765
FAC0032146;2015-08-30;CLI00482;FACTURA;8;1;141088;26807;167895
FAC0032147;2015-08-05;CLI00010;FACTURA;28;1;61029;11596;72625
FAC0032148;2015-03-17;CLI00598;FACTURA;45;1;32766;6226;38992
FAC0032149;2015-08-29;CLI00103;FACTURA;34;2;135355;25717;161072
FAC0032150;2015-07-21;CLI00840;FACTURA;48;1;199556;37916;237472
FAC0032151;2015-02-02;CLI00178;FACTURA;41;1;80178;15234;95412
FAC0032152;2015-07-15;CLI00775;FACTURA;2;2;55530;10551;66081
FAC0032153;2015-05-01;CLI00686;FACTURA;45;1;58518;11118;69636
FAC0032154;2015-09-06;CLI00864;FACTURA;45;1;37074;7044;44118
FAC0032155;2015-06-06;CLI00010;FACTURA;29;1;312390;59354;371744
FAC0032156;2015-01-30;CLI00389;FACTURA;16;2;28111;5341;33452
FAC0032157;2015-10-12;CLI00196;FACTURA;43;1;5638;1071;6709
FAC0032158;2015-01-07;CLI00651;FACTURA;41;2;285080;54165;339245
FAC0032159;2015-01-21;CLI00981;FACTURA;10;2;133236;25315;158551
FAC0032160;2015-11-24;CLI00101;FACTURA;11;2;113382;21543;134925
FAC0032161;2015-08-08;CLI00547;FACTURA;48;2;122058;23191;145249
FAC0032162;2015-06-06;CLI00446;FACTURA;34;1;40686;7730;48416
FAC0032163;2015-03-30;CLI00967;FACTURA;30;2;108972;20705;129677
FAC0032164;2015-10-22;CLI00121;FACTURA;26;2;174872;33226;208098
FAC0032165;2015-08-23;CLI00982;FACTURA;45;1;107050;20340;127390
FAC0032166;2015-07-18;CLI00163;FACTURA;19;2;75864;14414;90278
FAC0032167;2015-04-04;CLI00707;FACTURA;20;2;166254;31588;197842
FAC0032168;2015-08-06;CLI00066;FACTURA;28;1;27243;5176;32419
FAC0032169;2015-11-23;CLI00582;FACTURA;3;1;16922;3215;20137
FAC0032170;2015-12-11;CLI00251;FACTURA;24;2;108284;20574;128858
FAC0032171;2015-03-23;CLI00887;FACTURA;23;2;112444;21364;133808
FAC0032172;2015-10-01;CLI00069;FACTURA;8;2;88824;16877;105701
FAC0032173;2015-10-31;CLI00992;FACTURA;12;1;148008;28122;176130
FAC0032174;2015-12-28;CLI00632;FACTURA;38;1;55418;10529;65947
FAC0032175;2015-02-10;CLI00327;FACTURA;2;2;224888;42729;267617
FAC0032176;2015-05-04;CLI00654;FACTURA;27;1;10201;1938;12139
FAC0032177;2015-04-17;CLI00658;FACTURA;33;1;168936;32098;201034
FAC0032178;2015-01-09;CLI00478;FACTURA;17;1;265830;50508;316338
FAC0032179;2015-02-03;CLI00998;FACTURA;46;1;43002;8170;51172
FAC0032180;2015-07-30;CLI00594;FACTURA;35;1;16896;3210;20106
FAC0032181;2015-01-22;CLI00015;FACTURA;22;2;43253;8218;51471
FAC0032182;2015-01-12;CLI00910;FACTURA;15;1;84610;16076;100686
FAC0032183;2015-09-19;CLI00890;FACTURA;6;1;37020;7034;44054
FAC0032184;2015-09-11;CLI00828;FACTURA;41;1;216568;41148;257716
FAC0032185;2015-04-12;CLI00757;FACTURA;33;2;42234;8024;50258
FAC0032186;2015-03-26;CLI00812;FACTURA;30;1;105485;20042;125527
FAC0032187;2015-04-17;CLI00480;FACTURA;42;1;152838;29039;181877
FAC0032188;2015-09-02;CLI00842;FACTURA;13;1;48105;9140;57245
FAC0032189;2015-10-27;CLI00345;FACTURA;43;2;21117;4012;25129
FAC0032190;2015-04-02;CLI00293;FACTURA;49;2;83832;15928;99760
FAC0032191;2015-06-27;CLI00827;FACTURA;13;2;68374;12991;81365
FAC0032192;2015-06-17;CLI00794;FACTURA;27;1;71022;13494;84516
FAC0032193;2015-07-11;CLI00122;FACTURA;37;1;17636;3351;20987
FAC0032194;2015-03-25;CLI00328;FACTURA;12;1;218050;41430;259480
FAC0032195;2015-01-15;CLI00825;FACTURA;40;2;132915;25254;158169
FAC0032196;2015-04-20;CLI00052;FACTURA;45;1;199556;37916;237472
FAC0032197;2015-10-31;CLI00773;FACTURA;43;2;101532;19291;120823
FAC0032198;2015-03-26;CLI00099;FACTURA;22;2;43002;8170;51172
FAC0032199;2015-02-18;CLI00690;FACTURA;4;1;69608;13226;82834
FAC0032200;2015-11-23;CLI00516;FACTURA;47;1;27348;5196;32544
FAC0032201;2015-09-09;CLI00077;FACTURA;21;2;153013;29072;182085
FAC0032202;2015-07-02;CLI00962;FACTURA;6;1;65532;12451;77983
FAC0032203;2015-04-03;CLI00143;FACTURA;33;2;114032;21666;135698
FAC0032204;2015-04-11;CLI00863;FACTURA;21;2;265830;50508;316338
FAC0032205;2015-05-12;CLI00623;FACTURA;47;2;63351;12037;75388
FAC0032206;2015-03-30;CLI00232;FACTURA;32;1;50596;9613;60209
FAC0032207;2015-12-29;CLI00031;FACTURA;6;2;69420;13190;82610
FAC0032208;2015-10-08;CLI00202;FACTURA;8;1;196904;37412;234316
FAC0032209;2015-04-13;CLI00795;FACTURA;41;2;312390;59354;371744
FAC0032210;2015-08-27;CLI00735;FACTURA;49;2;170073;32314;202387
FAC0032211;2015-02-21;CLI00466;FACTURA;18;1;31784;6039;37823
FAC0032212;2015-12-01;CLI00788;FACTURA;18;1;153013;29072;182085
FAC0032213;2015-11-26;CLI00207;FACTURA;15;2;98452;18706;117158
FAC0032214;2015-08-02;CLI00269;FACTURA;18;2;122058;23191;145249
FAC0032215;2015-11-18;CLI00264;FACTURA;36;1;208824;39677;248501
FAC0032216;2015-08-09;CLI00435;FACTURA;24;2;268776;51067;319843
FAC0032217;2015-06-05;CLI00818;FACTURA;22;1;162426;30861;193287
FAC0032218;2015-10-07;CLI00659;FACTURA;34;2;190701;36233;226934
FAC0032219;2015-05-01;CLI00531;FACTURA;19;2;22908;4353;27261
FAC0032220;2015-07-24;CLI00908;FACTURA;35;1;50742;9641;60383
FAC0032221;2015-10-30;CLI00492;FACTURA;27;1;261027;49595;310622
FAC0032222;2015-04-18;CLI00371;FACTURA;7;2;42194;8017;50211
FAC0032223;2015-07-05;CLI00171;FACTURA;25;2;101192;19226;120418
FAC0032224;2015-08-14;CLI00093;FACTURA;46;2;49336;9374;58710
FAC0032225;2015-08-15;CLI00610;FACTURA;47;1;178311;33879;212190
FAC0032226;2015-03-18;CLI00789;FACTURA;16;2;56222;10682;66904
FAC0032227;2015-03-09;CLI00960;FACTURA;13;1;85014;16153;101167
FAC0032228;2015-04-28;CLI00546;FACTURA;40;1;127030;24136;151166
FAC0032229;2015-10-31;CLI00472;FACTURA;44;1;199556;37916;237472
FAC0032230;2015-04-21;CLI00041;FACTURA;38;2;24668;4687;29355
FAC0032231;2015-02-12;CLI00227;FACTURA;4;2;6170;1172;7342
FAC0032232;2015-05-22;CLI00477;FACTURA;49;2;31784;6039;37823
FAC0032233;2015-02-18;CLI00480;FACTURA;12;1;290030;55106;345136
FAC0032234;2015-09-17;CLI00539;FACTURA;35;2;94460;17947;112407
FAC0032235;2015-10-19;CLI00565;FACTURA;38;2;18510;3517;22027
FAC0032236;2015-04-26;CLI00697;FACTURA;38;2;87009;16532;103541
FAC0032237;2015-02-25;CLI00543;FACTURA;22;2;9446;1795;11241
FAC0032238;2015-11-04;CLI00382;FACTURA;10;1;216568;41148;257716
FAC0032239;2015-04-23;CLI00833;FACTURA;17;2;161176;30623;191799
FAC0032240;2015-12-06;CLI00984;FACTURA;28;1;270710;51435;322145
FAC0032241;2015-12-13;CLI00908;FACTURA;33;1;27243;5176;32419
FAC0032242;2015-06-25;CLI00763;FACTURA;11;2;8448;1605;10053
FAC0032243;2015-02-26;CLI00108;FACTURA;22;1;20402;3876;24278
FAC0032244;2015-10-16;CLI00556;FACTURA;45;1;58518;11118;69636
FAC0032245;2015-07-27;CLI00224;FACTURA;30;1;41022;7794;48816
FAC0032246;2015-02-08;CLI00502;FACTURA;17;1;50766;9646;60412
FAC0032247;2015-05-21;CLI00839;FACTURA;13;2;66618;12657;79275
FAC0032248;2015-02-03;CLI00691;FACTURA;3;2;45746;8692;54438
FAC0032249;2015-07-17;CLI00663;FACTURA;49;2;174018;33063;207081
FAC0032250;2015-04-13;CLI00263;FACTURA;26;2;197344;37495;234839
FAC0032251;2015-01-10;CLI00661;FACTURA;41;2;210970;40084;251054
FAC0032252;2015-02-02;CLI00297;FACTURA;23;2;10479;1991;12470
FAC0032253;2015-11-14;CLI00676;FACTURA;26;1;96816;18395;115211
FAC0032254;2015-06-26;CLI00696;FACTURA;48;1;61790;11740;73530
FAC0032255;2015-11-01;CLI00133;FACTURA;11;2;87009;16532;103541
FAC0032256;2015-10-08;CLI00221;FACTURA;33;2;18537;3522;22059
FAC0032257;2015-09-23;CLI00490;FACTURA;11;1;61206;11629;72835
FAC0032258;2015-12-25;CLI00933;FACTURA;4;2;98672;18748;117420
FAC0032259;2015-03-18;CLI00116;FACTURA;4;1;147819;28086;175905
FAC0032260;2015-10-30;CLI00602;FACTURA;45;1;281110;53411;334521
FAC0032261;2015-10-30;CLI00653;FACTURA;9;2;161176;30623;191799
FAC0032262;2015-08-03;CLI00869;FACTURA;5;2;101715;19326;121041
FAC0032263;2015-02-27;CLI00138;FACTURA;10;1;47676;9058;56734
FAC0032264;2015-12-17;CLI00838;FACTURA;16;1;101532;19291;120823
FAC0032265;2015-04-26;CLI00725;FACTURA;21;2;18897;3590;22487
FAC0032266;2015-05-27;CLI00109;FACTURA;2;2;42820;8136;50956
FAC0032267;2015-08-03;CLI00564;FACTURA;32;1;40686;7730;48416
FAC0032268;2015-12-28;CLI00962;FACTURA;16;1;16136;3066;19202
FAC0032269;2015-08-04;CLI00248;FACTURA;12;1;87220;16572;103792
FAC0032270;2015-08-03;CLI00592;FACTURA;7;1;104790;19910;124700
FAC0032271;2015-06-11;CLI00204;FACTURA;38;1;138545;26324;164869
FAC0032272;2015-05-17;CLI00722;FACTURA;4;1;57016;10833;67849
FAC0032273;2015-01-24;CLI00458;FACTURA;47;1;82044;15588;97632
FAC0032274;2015-11-17;CLI00639;FACTURA;6;2;174872;33226;208098
FAC0032275;2015-01-14;CLI00087;FACTURA;13;2;112444;21364;133808
FAC0032276;2015-11-01;CLI00600;FACTURA;22;1;55418;10529;65947
FAC0032277;2015-06-14;CLI00909;FACTURA;38;2;114540;21763;136303
FAC0032278;2015-02-08;CLI00644;FACTURA;27;1;290030;55106;345136
FAC0032279;2015-08-25;CLI00326;FACTURA;1;1;162744;30921;193665
FAC0032280;2015-04-06;CLI00469;FACTURA;23;2;273496;51964;325460
FAC0032281;2015-11-27;CLI00246;FACTURA;35;1;114672;21788;136460
FAC0032282;2015-07-19;CLI00339;FACTURA;47;2;169220;32152;201372
FAC0032283;2015-08-16;CLI00748;FACTURA;18;1;252980;48066;301046
FAC0032284;2015-11-30;CLI00272;FACTURA;50;1;80175;15233;95408
FAC0032285;2015-05-29;CLI00215;FACTURA;33;2;101192;19226;120418
FAC0032286;2015-07-08;CLI00892;FACTURA;44;1;9446;1795;11241
FAC0032287;2015-10-25;CLI00414;FACTURA;40;1;73839;14029;87868
FAC0032288;2015-04-25;CLI00320;FACTURA;24;1;90556;17206;107762
FAC0032289;2015-08-03;CLI00899;FACTURA;39;2;246680;46869;293549
FAC0032290;2015-12-03;CLI00802;FACTURA;20;1;152298;28937;181235
FAC0032291;2015-10-29;CLI00150;FACTURA;33;1;25406;4827;30233
FAC0032292;2015-08-04;CLI00595;FACTURA;16;2;172676;32808;205484
FAC0032293;2015-03-30;CLI00467;FACTURA;18;2;91314;17350;108664
FAC0032294;2015-06-02;CLI00619;FACTURA;8;2;245187;46586;291773
FAC0032295;2015-01-06;CLI00085;FACTURA;5;2;327660;62255;389915
FAC0032296;2015-12-07;CLI00358;FACTURA;22;1;43002;8170;51172
FAC0032297;2015-08-07;CLI00242;FACTURA;46;1;32272;6132;38404
FAC0032298;2015-07-13;CLI00105;FACTURA;4;2;28338;5384;33722
FAC0032299;2015-01-28;CLI00191;FACTURA;28;2;149870;28475;178345
FAC0032300;2015-08-30;CLI00157;FACTURA;7;2;35272;6702;41974
FAC0032301;2015-05-07;CLI00866;FACTURA;13;1;101892;19359;121251
FAC0032302;2015-06-22;CLI00640;FACTURA;14;1;327660;62255;389915
FAC0032303;2015-02-20;CLI00365;FACTURA;39;2;16922;3215;20137
FAC0032304;2015-05-05;CLI00541;FACTURA;47;2;56676;10768;67444
FAC0032305;2015-10-27;CLI00510;FACTURA;45;1;114032;21666;135698
FAC0032306;2015-10-26;CLI00315;FACTURA;12;2;108972;20705;129677
FAC0032307;2015-11-30;CLI00965;FACTURA;2;2;39730;7549;47279
FAC0032308;2015-11-05;CLI00951;FACTURA;38;2;147819;28086;175905
FAC0032309;2015-03-21;CLI00565;FACTURA;31;2;63351;12037;75388
FAC0032310;2015-07-22;CLI00324;FACTURA;4;1;114540;21763;136303
FAC0032311;2015-01-17;CLI00076;FACTURA;2;1;123066;23383;146449
FAC0032312;2015-01-27;CLI00082;FACTURA;36;1;83127;15794;98921
FAC0032313;2015-04-24;CLI00849;FACTURA;11;2;142401;27056;169457
FAC0032314;2015-07-11;CLI00640;FACTURA;15;1;182984;34767;217751
FAC0032315;2015-04-26;CLI00245;FACTURA;18;2;174872;33226;208098
FAC0032316;2015-11-29;CLI00898;FACTURA;42;1;135376;25721;161097
FAC0032317;2015-12-07;CLI00075;FACTURA;16;2;58518;11118;69636
FAC0032318;2015-02-25;CLI00335;FACTURA;17;2;246680;46869;293549
FAC0032319;2015-02-18;CLI00394;FACTURA;27;1;163830;31128;194958
FAC0032320;2015-05-18;CLI00485;FACTURA;23;2;37074;7044;44118
FAC0032321;2015-07-01;CLI00610;FACTURA;14;1;40584;7711;48295
FAC0032322;2015-01-08;CLI00001;FACTURA;32;2;45278;8603;53881
FAC0032323;2015-12-19;CLI00303;FACTURA;36;2;37074;7044;44118
FAC0032324;2015-07-08;CLI00032;FACTURA;46;1;147678;28059;175737
FAC0032325;2015-08-28;CLI00813;FACTURA;30;2;270710;51435;322145
FAC0032326;2015-10-21;CLI00677;FACTURA;30;2;45278;8603;53881
FAC0032327;2015-02-07;CLI00871;FACTURA;10;2;174440;33144;207584
FAC0032328;2015-05-25;CLI00575;FACTURA;14;2;87436;16613;104049
FAC0032329;2015-03-15;CLI00943;FACTURA;31;2;102010;19382;121392
FAC0032330;2015-02-14;CLI00651;FACTURA;20;2;52908;10053;62961
FAC0032331;2015-09-07;CLI00055;FACTURA;8;2;50766;9646;60412
FAC0032332;2015-08-28;CLI00424;FACTURA;36;1;95718;18186;113904
FAC0032333;2015-04-14;CLI00217;FACTURA;32;2;81729;15529;97258
FAC0032334;2015-06-01;CLI00708;FACTURA;30;1;101624;19309;120933
FAC0032335;2015-09-10;CLI00416;FACTURA;46;1;76032;14446;90478
FAC0032336;2015-09-07;CLI00243;FACTURA;23;2;239247;45457;284704
FAC0032337;2015-12-09;CLI00977;FACTURA;5;2;50742;9641;60383
FAC0032338;2015-09-22;CLI00245;FACTURA;1;2;35272;6702;41974
FAC0032339;2015-03-10;CLI00126;FACTURA;26;1;74004;14061;88065
FAC0032340;2015-02-11;CLI00697;FACTURA;9;2;66381;12612;78993
FAC0032341;2015-09-21;CLI00344;FACTURA;14;1;54696;10392;65088
FAC0032342;2015-08-25;CLI00339;FACTURA;39;2;174020;33064;207084
FAC0032343;2015-07-19;CLI00503;FACTURA;28;2;176360;33508;209868
FAC0032344;2015-05-03;CLI00364;FACTURA;10;1;102010;19382;121392
FAC0032345;2015-05-31;CLI00973;FACTURA;31;2;214100;40679;254779
FAC0032346;2015-02-05;CLI00950;FACTURA;15;1;192690;36611;229301
FAC0032347;2015-11-20;CLI00644;FACTURA;36;1;104412;19838;124250
FAC0032348;2015-05-17;CLI00015;FACTURA;8;2;80588;15312;95900
FAC0032349;2015-12-20;CLI00771;FACTURA;3;2;112245;21327;133572
FAC0032350;2015-11-24;CLI00962;FACTURA;41;1;17636;3351;20987
FAC0032351;2015-12-28;CLI00237;FACTURA;8;2;120882;22968;143850
FAC0032352;2015-10-25;CLI00735;FACTURA;5;2;168936;32098;201034
FAC0032353;2015-11-28;CLI00172;FACTURA;38;1;105485;20042;125527
FAC0032354;2015-08-07;CLI00652;FACTURA;21;1;34710;6595;41305
FAC0032355;2015-02-25;CLI00088;FACTURA;17;1;27243;5176;32419
FAC0032356;2015-02-25;CLI00987;FACTURA;33;2;25344;4815;30159
FAC0032357;2015-07-28;CLI00583;FACTURA;1;2;11454;2176;13630
FAC0032358;2015-09-25;CLI00418;FACTURA;30;1;25406;4827;30233
FAC0032359;2015-05-30;CLI00215;FACTURA;22;2;208824;39677;248501
FAC0032360;2015-01-22;CLI00049;FACTURA;18;2;71022;13494;84516
FAC0032361;2015-04-01;CLI00441;FACTURA;42;2;132915;25254;158169
FAC0032362;2015-12-13;CLI00715;FACTURA;14;2;145015;27553;172568
FAC0032363;2015-02-18;CLI00137;FACTURA;24;2;85524;16250;101774
FAC0032364;2015-01-17;CLI00297;FACTURA;9;2;262128;49804;311932
FAC0032365;2015-04-05;CLI00318;FACTURA;35;1;22639;4301;26940
FAC0032366;2015-01-14;CLI00535;FACTURA;7;2;95718;18186;113904
FAC0032367;2015-02-03;CLI00987;FACTURA;43;2;63351;12037;75388
FAC0032368;2015-06-22;CLI00777;FACTURA;31;2;104130;19785;123915
FAC0032369;2015-11-02;CLI00307;FACTURA;8;2;147679;28059;175738
FAC0032370;2015-02-05;CLI00078;FACTURA;4;1;42820;8136;50956
FAC0032371;2015-04-10;CLI00936;FACTURA;46;1;201470;38279;239749
FAC0032372;2015-08-18;CLI00642;FACTURA;37;1;67194;12767;79961
FAC0032373;2015-02-24;CLI00282;FACTURA;18;1;65532;12451;77983
FAC0032374;2015-12-13;CLI00815;FACTURA;22;2;91809;17444;109253
FAC0032375;2015-08-07;CLI00975;FACTURA;45;2;168666;32047;200713
FAC0032376;2015-02-14;CLI00185;FACTURA;32;2;75568;14358;89926
FAC0032377;2015-11-18;CLI00857;FACTURA;18;2;64140;12187;76327
FAC0032378;2015-08-14;CLI00273;FACTURA;39;2;55611;10566;66177
FAC0032379;2015-10-31;CLI00602;FACTURA;45;1;172676;32808;205484
FAC0032380;2015-05-01;CLI00008;FACTURA;11;1;216568;41148;257716
FAC0032381;2015-03-13;CLI00793;FACTURA;31;2;224888;42729;267617
FAC0032382;2015-05-10;CLI00474;FACTURA;49;1;32272;6132;38404
FAC0032383;2015-08-21;CLI00556;FACTURA;33;1;34710;6595;41305
FAC0032384;2015-05-29;CLI00450;FACTURA;5;1;221672;42118;263790
FAC0032385;2015-11-18;CLI00594;FACTURA;37;1;131154;24919;156073
FAC0032386;2015-12-05;CLI00116;FACTURA;31;1;228064;43332;271396
FAC0032387;2015-05-08;CLI00603;FACTURA;17;2;31437;5973;37410
FAC0032388;2015-10-31;CLI00787;FACTURA;33;2;11276;2142;13418
FAC0032389;2015-08-19;CLI00172;FACTURA;22;1;102010;19382;121392
FAC0032390;2015-06-10;CLI00468;FACTURA;39;1;152298;28937;181235
FAC0032391;2015-08-24;CLI00450;FACTURA;37;1;27071;5143;32214
FAC0032392;2015-08-08;CLI00491;FACTURA;45;2;114672;21788;136460
FAC0032393;2015-05-01;CLI00997;FACTURA;40;2;53166;10102;63268
FAC0032394;2015-11-01;CLI00291;FACTURA;7;2;137238;26075;163313
FAC0032395;2015-05-03;CLI00169;FACTURA;31;2;136748;25982;162730
FAC0032396;2015-07-08;CLI00779;FACTURA;31;2;9446;1795;11241
FAC0032397;2015-03-03;CLI00077;FACTURA;7;2;168936;32098;201034
FAC0032398;2015-08-10;CLI00073;FACTURA;2;2;61206;11629;72835
FAC0032399;2015-02-02;CLI00192;FACTURA;12;1;100338;19064;119402
FAC0032400;2015-01-24;CLI00145;FACTURA;15;2;54696;10392;65088
FAC0032401;2015-03-15;CLI00131;FACTURA;31;2;32766;6226;38992
FAC0032402;2015-04-11;CLI00875;FACTURA;45;2;73353;13937;87290
FAC0032403;2015-10-19;CLI00411;FACTURA;2;2;327660;62255;389915
FAC0032404;2015-10-31;CLI00520;FACTURA;36;1;109025;20715;129740
FAC0032405;2015-10-22;CLI00868;FACTURA;28;1;102010;19382;121392
FAC0032406;2015-02-06;CLI00009;FACTURA;45;2;105816;20105;125921
FAC0032407;2015-01-05;CLI00515;FACTURA;6;2;226390;43014;269404
FAC0032408;2015-06-24;CLI00348;FACTURA;5;1;167985;31917;199902
FAC0032409;2015-09-13;CLI00903;FACTURA;42;2;116012;22042;138054
FAC0032410;2015-12-03;CLI00736;FACTURA;48;1;52908;10053;62961
FAC0032411;2015-08-17;CLI00635;FACTURA;7;2;71407;13567;84974
FAC0032412;2015-02-22;CLI00456;FACTURA;8;1;126582;24051;150633
FAC0032413;2015-06-18;CLI00491;FACTURA;8;2;28111;5341;33452
FAC0032414;2015-01-06;CLI00036;FACTURA;8;1;97530;18531;116061
FAC0032415;2015-03-13;CLI00621;FACTURA;24;2;43190;8206;51396
FAC0032416;2015-05-23;CLI00632;FACTURA;48;1;21410;4068;25478
FAC0032417;2015-03-09;CLI00088;FACTURA;45;1;56380;10712;67092
FAC0032418;2015-03-26;CLI00731;FACTURA;42;2;203784;38719;242503
FAC0032419;2015-10-31;CLI00555;FACTURA;25;2;21805;4143;25948
FAC0032420;2015-06-22;CLI00925;FACTURA;34;2;140555;26705;167260
FAC0032421;2015-07-29;CLI00886;FACTURA;2;1;13674;2598;16272
FAC0032422;2015-12-07;CLI00476;FACTURA;41;1;245187;46586;291773
FAC0032423;2015-01-16;CLI00929;FACTURA;25;2;54142;10287;64429
FAC0032424;2015-10-15;CLI00766;FACTURA;36;1;25298;4807;30105
FAC0032425;2015-03-23;CLI00714;FACTURA;24;1;25298;4807;30105
FAC0032426;2015-10-02;CLI01000;FACTURA;1;1;24613;4676;29289
FAC0032427;2015-08-10;CLI00664;FACTURA;38;1;175554;33355;208909
FAC0032428;2015-03-09;CLI00017;FACTURA;49;2;20402;3876;24278
FAC0032429;2015-09-11;CLI00662;FACTURA;39;1;175554;33355;208909
FAC0032430;2015-02-10;CLI00857;FACTURA;28;2;163830;31128;194958
FAC0032431;2015-01-03;CLI00611;FACTURA;44;2;55530;10551;66081
FAC0032432;2015-10-09;CLI00226;FACTURA;13;1;62874;11946;74820
FAC0032433;2015-02-16;CLI00722;FACTURA;16;1;85640;16272;101912
FAC0032434;2015-03-02;CLI00609;FACTURA;7;2;24668;4687;29355
FAC0032435;2015-10-06;CLI00091;FACTURA;16;2;85014;16153;101167
FAC0032436;2015-08-07;CLI00616;FACTURA;47;1;67688;12861;80549
FAC0032437;2015-03-10;CLI00675;FACTURA;4;2;110836;21059;131895
FAC0032438;2015-01-02;CLI00465;FACTURA;33;2;136215;25881;162096
FAC0032439;2015-06-22;CLI00132;FACTURA;3;1;22552;4285;26837
FAC0032440;2015-09-23;CLI00646;FACTURA;16;1;168666;32047;200713
FAC0032441;2015-10-08;CLI00414;FACTURA;37;1;138840;26380;165220
FAC0032442;2015-10-23;CLI00173;FACTURA;49;2;265830;50508;316338
FAC0032443;2015-07-20;CLI00312;FACTURA;32;1;163458;31057;194515
FAC0032444;2015-09-05;CLI00676;FACTURA;15;1;45104;8570;53674
FAC0032445;2015-03-04;CLI00919;FACTURA;9;2;68619;13038;81657
FAC0032446;2015-07-09;CLI00850;FACTURA;31;1;42194;8017;50211
FAC0032447;2015-12-16;CLI00203;FACTURA;33;2;47230;8974;56204
FAC0032448;2015-02-11;CLI00110;FACTURA;15;1;87009;16532;103541
FAC0032449;2015-01-30;CLI00319;FACTURA;14;2;131154;24919;156073
FAC0032450;2015-03-19;CLI00059;FACTURA;29;2;73353;13937;87290
FAC0032451;2015-06-05;CLI00356;FACTURA;35;1;156048;29649;185697
FAC0032452;2015-04-07;CLI00678;FACTURA;4;1;65577;12460;78037
FAC0032453;2015-05-25;CLI00695;FACTURA;47;2;64544;12263;76807
FAC0032454;2015-09-05;CLI00650;FACTURA;46;1;64140;12187;76327
FAC0032455;2015-09-04;CLI00565;FACTURA;25;2;12358;2348;14706
FAC0032456;2015-03-31;CLI00923;FACTURA;5;2;31784;6039;37823
FAC0032457;2015-09-06;CLI00984;FACTURA;13;1;140555;26705;167260
FAC0032458;2015-02-26;CLI00197;FACTURA;50;2;203751;38713;242464
FAC0032459;2015-11-07;CLI00168;FACTURA;31;1;20147;3828;23975
FAC0032460;2015-03-15;CLI00170;FACTURA;45;1;79749;15152;94901
FAC0032461;2015-07-16;CLI00460;FACTURA;9;1;239247;45457;284704
FAC0032462;2015-12-09;CLI00758;FACTURA;14;1;28338;5384;33722
FAC0032463;2015-04-11;CLI00243;FACTURA;34;2;169220;32152;201372
FAC0032464;2015-12-09;CLI00973;FACTURA;38;2;101715;19326;121041
FAC0032465;2015-01-22;CLI00133;FACTURA;3;2;131064;24902;155966
FAC0032466;2015-11-23;CLI00620;FACTURA;11;1;24613;4676;29289
FAC0032467;2015-06-14;CLI00544;FACTURA;14;1;312390;59354;371744
FAC0032468;2015-07-24;CLI00353;FACTURA;41;2;128280;24373;152653
FAC0032469;2015-03-17;CLI00701;FACTURA;11;2;26583;5051;31634
FAC0032470;2015-03-12;CLI00572;FACTURA;20;1;246130;46765;292895
FAC0032471;2015-11-10;CLI00396;FACTURA;1;1;132279;25133;157412
FAC0032472;2015-05-06;CLI00149;FACTURA;2;2;65532;12451;77983
FAC0032473;2015-08-23;CLI00422;FACTURA;50;1;59585;11321;70906
FAC0032474;2015-01-23;CLI00252;FACTURA;32;1;40686;7730;48416
FAC0032475;2015-10-20;CLI00930;FACTURA;45;1;57336;10894;68230
FAC0032476;2015-10-20;CLI00243;FACTURA;38;2;76419;14520;90939
FAC0032477;2015-11-07;CLI00684;FACTURA;19;1;73839;14029;87868
FAC0032478;2015-11-01;CLI00944;FACTURA;39;1;68370;12990;81360
FAC0032479;2015-11-09;CLI00681;FACTURA;14;2;83127;15794;98921
FAC0032480;2015-08-03;CLI00179;FACTURA;39;2;114365;21729;136094
FAC0032481;2015-09-28;CLI00080;FACTURA;30;1;335970;63834;399804
FAC0032482;2015-10-28;CLI00767;FACTURA;29;2;341870;64955;406825
FAC0032483;2015-01-08;CLI00417;FACTURA;37;2;228064;43332;271396
FAC0032484;2015-02-18;CLI00819;FACTURA;29;2;43190;8206;51396
FAC0032485;2015-07-08;CLI00942;FACTURA;21;1;123452;23456;146908
FAC0032486;2015-01-13;CLI00828;FACTURA;37;1;186081;35355;221436
FAC0032487;2015-02-05;CLI00055;FACTURA;12;2;118454;22506;140960
FAC0032488;2015-12-07;CLI00181;FACTURA;7;2;96210;18280;114490
FAC0032489;2015-05-22;CLI00076;FACTURA;4;1;135834;25808;161642
FAC0032490;2015-12-28;CLI00691;FACTURA;45;2;144315;27420;171735
FAC0032491;2015-03-20;CLI00780;FACTURA;40;1;5638;1071;6709
FAC0032492;2015-04-17;CLI00215;FACTURA;4;2;171280;32543;203823
FAC0032493;2015-04-01;CLI00977;FACTURA;4;2;66618;12657;79275
FAC0032494;2015-05-03;CLI00681;FACTURA;5;2;39012;7412;46424
FAC0032495;2015-08-25;CLI00004;FACTURA;3;1;58518;11118;69636
FAC0032496;2015-12-15;CLI00736;FACTURA;6;1;40804;7753;48557
FAC0032497;2015-12-26;CLI00942;FACTURA;16;1;132915;25254;158169
FAC0032498;2015-10-23;CLI00141;FACTURA;27;2;58518;11118;69636
FAC0032499;2015-01-05;CLI00854;FACTURA;18;1;63568;12078;75646
FAC0032500;2015-12-09;CLI00157;FACTURA;30;2;85014;16153;101167
FAC0032501;2015-03-21;CLI00842;FACTURA;45;1;85347;16216;101563
FAC0032502;2015-02-16;CLI00577;FACTURA;7;2;312390;59354;371744
FAC0032503;2015-05-10;CLI00888;FACTURA;47;1;205857;39113;244970
FAC0032504;2015-01-05;CLI00955;FACTURA;2;2;181323;34451;215774
FAC0032505;2015-10-03;CLI00305;FACTURA;1;2;53166;10102;63268
FAC0032506;2015-06-03;CLI00072;FACTURA;31;1;56691;10771;67462
FAC0032507;2015-01-31;CLI00254;FACTURA;21;1;66618;12657;79275
FAC0032508;2015-09-06;CLI00094;FACTURA;15;1;50688;9631;60319
FAC0032509;2015-07-15;CLI00776;FACTURA;38;1;218050;41430;259480
FAC0032510;2015-02-13;CLI00580;FACTURA;38;1;67688;12861;80549
FAC0032511;2015-01-25;CLI00422;FACTURA;9;1;205122;38973;244095
FAC0032512;2015-12-21;CLI00441;FACTURA;48;2;23838;4529;28367
FAC0032513;2015-01-22;CLI00678;FACTURA;45;1;43253;8218;51471
FAC0032514;2015-01-20;CLI00547;FACTURA;2;2;9446;1795;11241
FAC0032515;2015-08-29;CLI00498;FACTURA;12;1;87009;16532;103541
FAC0032516;2015-02-25;CLI00312;FACTURA;37;1;168776;32067;200843
FAC0032517;2015-12-05;CLI00579;FACTURA;42;2;195060;37061;232121
FAC0032518;2015-06-08;CLI00073;FACTURA;33;2;68724;13058;81782
FAC0032519;2015-11-07;CLI00671;FACTURA;10;2;188970;35904;224874
FAC0032520;2015-01-28;CLI00319;FACTURA;36;2;33792;6420;40212
FAC0032521;2015-03-01;CLI00022;FACTURA;19;1;167985;31917;199902
FAC0032522;2015-09-24;CLI00371;FACTURA;50;2;19506;3706;23212
FAC0032523;2015-03-30;CLI00760;FACTURA;9;1;56380;10712;67092
FAC0032524;2015-04-02;CLI00285;FACTURA;4;2;87220;16572;103792
FAC0032525;2015-06-09;CLI00342;FACTURA;34;1;134388;25534;159922
FAC0032526;2015-09-22;CLI00242;FACTURA;24;1;43002;8170;51172
FAC0032527;2015-06-01;CLI00907;FACTURA;16;2;101624;19309;120933
FAC0032528;2015-01-09;CLI00718;FACTURA;37;1;81168;15422;96590
FAC0032529;2015-05-03;CLI00623;FACTURA;2;2;175554;33355;208909
FAC0032530;2015-07-16;CLI00070;FACTURA;32;1;122058;23191;145249
FAC0032531;2015-11-25;CLI00048;FACTURA;48;1;254060;48271;302331
FAC0032532;2015-10-02;CLI00438;FACTURA;30;1;152838;29039;181877
FAC0032533;2015-01-19;CLI00412;FACTURA;21;1;73839;14029;87868
FAC0032534;2015-02-14;CLI00943;FACTURA;12;2;21410;4068;25478
FAC0032535;2015-01-12;CLI00756;FACTURA;27;1;84468;16049;100517
FAC0032536;2015-07-08;CLI00261;FACTURA;1;2;107050;20340;127390
FAC0032537;2015-06-11;CLI00667;FACTURA;49;2;134388;25534;159922
FAC0032538;2015-12-21;CLI00761;FACTURA;17;2;22873;4346;27219
FAC0032539;2015-01-31;CLI00646;FACTURA;9;1;50946;9680;60626
FAC0032540;2015-06-17;CLI00242;FACTURA;1;1;43253;8218;51471
FAC0032541;2015-09-05;CLI00828;FACTURA;1;1;29003;5511;34514
FAC0032542;2015-11-01;CLI00227;FACTURA;34;2;172291;32735;205026
FAC0032543;2015-12-14;CLI00903;FACTURA;21;2;28508;5417;33925
FAC0032544;2015-01-06;CLI00733;FACTURA;19;2;21117;4012;25129
FAC0032545;2015-06-21;CLI00067;FACTURA;27;2;114672;21788;136460
FAC0032546;2015-05-10;CLI00079;FACTURA;50;2;10146;1928;12074
FAC0032547;2015-05-08;CLI00021;FACTURA;32;2;208824;39677;248501
FAC0032548;2015-11-28;CLI00888;FACTURA;16;1;63568;12078;75646
FAC0032549;2015-09-28;CLI00597;FACTURA;38;2;212664;40406;253070
FAC0032550;2015-01-21;CLI00265;FACTURA;42;2;170073;32314;202387
FAC0032551;2015-01-09;CLI00109;FACTURA;23;2;10146;1928;12074
FAC0032552;2015-04-01;CLI00340;FACTURA;16;1;18510;3517;22027
FAC0032553;2015-05-22;CLI00794;FACTURA;37;1;30895;5870;36765
FAC0032554;2015-03-01;CLI00599;FACTURA;36;2;136740;25981;162721
FAC0032555;2015-04-28;CLI00925;FACTURA;30;2;44412;8438;52850
FAC0032556;2015-04-30;CLI00356;FACTURA;11;1;141029;26796;167825
FAC0032557;2015-10-14;CLI00708;FACTURA;6;1;27709;5265;32974
FAC0032558;2015-08-07;CLI00142;FACTURA;12;1;81168;15422;96590
FAC0032559;2015-05-08;CLI00149;FACTURA;33;2;55611;10566;66177
FAC0032560;2015-04-12;CLI00041;FACTURA;45;2;57336;10894;68230
FAC0032561;2015-01-29;CLI00283;FACTURA;21;2;94460;17947;112407
FAC0032562;2015-04-05;CLI00131;FACTURA;32;2;145015;27553;172568
FAC0032563;2015-06-07;CLI00027;FACTURA;26;2;109392;20784;130176
FAC0032564;2015-02-12;CLI00696;FACTURA;23;1;254060;48271;302331
FAC0032565;2015-05-08;CLI00200;FACTURA;1;1;68374;12991;81365
FAC0032566;2015-03-17;CLI00191;FACTURA;7;2;32070;6093;38163
FAC0032567;2015-11-13;CLI00542;FACTURA;7;1;74004;14061;88065
FAC0032568;2015-02-27;CLI00673;FACTURA;3;2;335970;63834;399804
FAC0032569;2015-04-21;CLI00109;FACTURA;34;2;83832;15928;99760
FAC0032570;2015-12-02;CLI00986;FACTURA;36;1;129088;24527;153615
FAC0032571;2015-01-21;CLI00802;FACTURA;41;1;203021;38574;241595
FAC0032572;2015-03-23;CLI00323;FACTURA;9;2;168936;32098;201034
FAC0032573;2015-02-16;CLI00459;FACTURA;14;2;123340;23435;146775
FAC0032574;2015-04-30;CLI00241;FACTURA;4;2;239247;45457;284704
FAC0032575;2015-07-29;CLI00234;FACTURA;40;1;65577;12460;78037
FAC0032576;2015-01-30;CLI00196;FACTURA;45;1;43718;8306;52024
FAC0032577;2015-05-21;CLI00533;FACTURA;37;2;307683;58460;366143
FAC0032578;2015-11-18;CLI00918;FACTURA;30;1;196904;37412;234316
FAC0032579;2015-04-18;CLI00301;FACTURA;11;2;294894;56030;350924
FAC0032580;2015-02-09;CLI00771;FACTURA;39;2;268776;51067;319843
FAC0032581;2015-09-29;CLI00763;FACTURA;38;2;66618;12657;79275
FAC0032582;2015-06-20;CLI00678;FACTURA;21;1;67194;12767;79961
FAC0032583;2015-06-19;CLI00074;FACTURA;3;1;123065;23382;146447
FAC0032584;2015-05-05;CLI00361;FACTURA;49;2;129006;24511;153517
FAC0032585;2015-04-06;CLI00389;FACTURA;13;2;20292;3855;24147
FAC0032586;2015-06-26;CLI00269;FACTURA;46;2;32070;6093;38163
FAC0032587;2015-01-04;CLI00685;FACTURA;48;2;61700;11723;73423
FAC0032588;2015-09-09;CLI00627;FACTURA;41;2;201582;38301;239883
FAC0032589;2015-10-03;CLI00411;FACTURA;19;2;203751;38713;242464
FAC0032590;2015-11-20;CLI00536;FACTURA;45;1;302373;57451;359824
FAC0032591;2015-03-15;CLI00224;FACTURA;34;1;90556;17206;107762
FAC0032592;2015-09-02;CLI00414;FACTURA;23;1;133236;25315;158551
FAC0032593;2015-09-03;CLI00097;FACTURA;23;2;123340;23435;146775
FAC0032594;2015-04-11;CLI00848;FACTURA;28;1;174440;33144;207584
FAC0032595;2015-11-05;CLI00800;FACTURA;6;1;126582;24051;150633
FAC0032596;2015-06-29;CLI00750;FACTURA;36;1;84610;16076;100686
FAC0032597;2015-07-24;CLI00425;FACTURA;47;2;172291;32735;205026
FAC0032598;2015-03-29;CLI00239;FACTURA;21;2;189497;36004;225501
FAC0032599;2015-01-31;CLI00061;FACTURA;20;2;10479;1991;12470
FAC0032600;2015-04-29;CLI00358;FACTURA;15;1;102010;19382;121392
FAC0032601;2015-11-22;CLI00671;FACTURA;40;2;112952;21461;134413
FAC0032602;2015-05-20;CLI00609;FACTURA;31;2;42820;8136;50956
FAC0032603;2015-03-04;CLI00214;FACTURA;42;1;160111;30421;190532
FAC0032604;2015-08-07;CLI00570;FACTURA;26;1;172291;32735;205026
FAC0032605;2015-01-21;CLI00039;FACTURA;21;2;196596;37353;233949
FAC0032606;2015-10-14;CLI00039;FACTURA;8;2;143340;27235;170575
FAC0032607;2015-05-03;CLI00213;FACTURA;38;2;11454;2176;13630
FAC0032608;2015-04-28;CLI00321;FACTURA;24;2;105816;20105;125921
FAC0032609;2015-09-17;CLI00809;FACTURA;35;2;114540;21763;136303
FAC0032610;2015-10-12;CLI00799;FACTURA;24;2;100791;19150;119941
FAC0032611;2015-09-14;CLI00498;FACTURA;10;1;270710;51435;322145
FAC0032612;2015-05-10;CLI00423;FACTURA;43;2;212664;40406;253070
FAC0032613;2015-09-17;CLI00928;FACTURA;43;1;168666;32047;200713
FAC0032614;2015-02-10;CLI00306;FACTURA;39;1;52908;10053;62961
FAC0032615;2015-03-21;CLI00293;FACTURA;15;2;85640;16272;101912
FAC0032616;2015-05-02;CLI00563;FACTURA;33;2;129006;24511;153517
FAC0032617;2015-03-26;CLI00986;FACTURA;41;1;177842;33790;211632
FAC0032618;2015-12-07;CLI00189;FACTURA;35;2;147678;28059;175737
FAC0032619;2015-08-27;CLI00412;FACTURA;43;1;222012;42182;264194
FAC0032620;2015-01-08;CLI00532;FACTURA;41;1;169220;32152;201372
FAC0032621;2015-08-25;CLI00990;FACTURA;16;1;16035;3047;19082
FAC0032622;2015-02-06;CLI00793;FACTURA;44;2;87436;16613;104049
FAC0032623;2015-12-25;CLI00413;FACTURA;11;2;45816;8705;54521
FAC0032624;2015-08-13;CLI00984;FACTURA;32;1;31437;5973;37410
FAC0032625;2015-08-05;CLI00816;FACTURA;4;1;144315;27420;171735
FAC0032626;2015-02-16;CLI00594;FACTURA;41;1;347100;65949;413049
FAC0032627;2015-08-13;CLI00782;FACTURA;29;1;181323;34451;215774
FAC0032628;2015-10-02;CLI00413;FACTURA;33;2;141029;26796;167825
FAC0032629;2015-12-04;CLI00209;FACTURA;34;2;56222;10682;66904
FAC0032630;2015-06-17;CLI00593;FACTURA;1;2;24680;4689;29369
FAC0032631;2015-05-10;CLI00935;FACTURA;16;2;11276;2142;13418
FAC0032632;2015-11-12;CLI00772;FACTURA;48;1;161360;30658;192018
FAC0032633;2015-02-02;CLI00917;FACTURA;5;2;84480;16051;100531
FAC0032634;2015-10-05;CLI00730;FACTURA;48;1;81168;15422;96590
FAC0032635;2015-02-07;CLI00742;FACTURA;30;1;63291;12025;75316
FAC0032636;2015-12-31;CLI00738;FACTURA;42;1;126490;24033;150523
FAC0032637;2015-04-03;CLI00712;FACTURA;13;1;73839;14029;87868
FAC0032638;2015-12-24;CLI00079;FACTURA;28;2;243628;46289;289917
FAC0032639;2015-06-25;CLI00624;FACTURA;17;1;160350;30467;190817
FAC0032640;2015-06-14;CLI00068;FACTURA;7;1;11276;2142;13418
FAC0032641;2015-08-10;CLI00085;FACTURA;44;2;261027;49595;310622
FAC0032642;2015-06-27;CLI00637;FACTURA;22;2;44412;8438;52850
FAC0032643;2015-07-05;CLI00246;FACTURA;16;1;212664;40406;253070
FAC0032644;2015-05-28;CLI00128;FACTURA;34;1;114032;21666;135698
FAC0032645;2015-11-02;CLI00792;FACTURA;30;1;53166;10102;63268
FAC0032646;2015-12-05;CLI00085;FACTURA;42;2;262128;49804;311932
FAC0032647;2015-05-29;CLI00152;FACTURA;35;1;129088;24527;153615
FAC0032648;2015-09-02;CLI00498;FACTURA;14;1;196731;37379;234110
FAC0032649;2015-12-14;CLI00347;FACTURA;12;2;61700;11723;73423
FAC0032650;2015-07-16;CLI00143;FACTURA;3;2;47668;9057;56725
FAC0032651;2015-09-10;CLI00298;FACTURA;11;1;203248;38617;241865
FAC0032652;2015-09-05;CLI00390;FACTURA;24;1;168776;32067;200843
FAC0032653;2015-10-04;CLI00717;FACTURA;20;2;41022;7794;48816
FAC0032654;2015-04-11;CLI00732;FACTURA;2;1;21117;4012;25129
FAC0032655;2015-02-22;CLI00013;FACTURA;22;2;51005;9691;60696
FAC0032656;2015-08-29;CLI00575;FACTURA;11;2;84610;16076;100686
FAC0032657;2015-06-14;CLI00699;FACTURA;7;2;128460;24407;152867
FAC0032658;2015-06-22;CLI00997;FACTURA;48;2;11454;2176;13630
FAC0032659;2015-09-18;CLI00966;FACTURA;34;1;136740;25981;162721
FAC0032660;2015-10-31;CLI00540;FACTURA;5;1;196731;37379;234110
FAC0032661;2015-07-24;CLI00678;FACTURA;49;1;87009;16532;103541
FAC0032662;2015-06-10;CLI00833;FACTURA;19;2;70544;13403;83947
FAC0032663;2015-04-11;CLI00349;FACTURA;17;2;120882;22968;143850
FAC0032664;2015-07-29;CLI00109;FACTURA;18;2;177842;33790;211632
FAC0032665;2015-11-21;CLI00206;FACTURA;44;1;56676;10768;67444
FAC0032666;2015-12-11;CLI00378;FACTURA;27;1;120882;22968;143850
FAC0032667;2015-03-18;CLI00102;FACTURA;33;1;75864;14414;90278
FAC0032668;2015-02-28;CLI00893;FACTURA;1;2;153013;29072;182085
FAC0032669;2015-04-18;CLI00699;FACTURA;44;2;35272;6702;41974
FAC0032670;2015-01-17;CLI00338;FACTURA;25;1;208824;39677;248501
FAC0032671;2015-07-14;CLI00818;FACTURA;11;1;174440;33144;207584
FAC0032672;2015-01-06;CLI00878;FACTURA;30;1;28508;5417;33925
FAC0032673;2015-07-13;CLI00990;FACTURA;45;1;111030;21096;132126
FAC0032674;2015-07-08;CLI00689;FACTURA;28;2;47676;9058;56734
FAC0032675;2015-03-17;CLI00228;FACTURA;5;1;50742;9641;60383
FAC0032676;2015-10-13;CLI00792;FACTURA;10;1;140555;26705;167260
FAC0032677;2015-02-15;CLI00063;FACTURA;16;2;55611;10566;66177
FAC0032678;2015-10-16;CLI00772;FACTURA;19;1;117036;22237;139273
FAC0032679;2015-09-13;CLI00185;FACTURA;6;2;10479;1991;12470
FAC0032680;2015-08-26;CLI00188;FACTURA;48;1;16136;3066;19202
FAC0032681;2015-03-09;CLI00459;FACTURA;43;2;196777;37388;234165
FAC0032682;2015-10-31;CLI00654;FACTURA;29;1;239247;45457;284704
FAC0032683;2015-07-17;CLI00409;FACTURA;9;2;127030;24136;151166
FAC0032684;2015-10-19;CLI00299;FACTURA;7;2;203784;38719;242503
FAC0032685;2015-08-12;CLI00456;FACTURA;6;1;74004;14061;88065
FAC0032686;2015-08-17;CLI00227;FACTURA;3;2;59136;11236;70372
FAC0032687;2015-04-14;CLI00230;FACTURA;4;1;80175;15233;95408
FAC0032688;2015-01-22;CLI00024;FACTURA;15;1;28668;5447;34115
FAC0032689;2015-01-08;CLI00784;FACTURA;43;1;50596;9613;60209
FAC0032690;2015-10-27;CLI00059;FACTURA;14;2;64230;12204;76434
FAC0032691;2015-01-05;CLI00101;FACTURA;49;2;43718;8306;52024
FAC0032692;2015-08-25;CLI00934;FACTURA;34;1;16035;3047;19082
FAC0032693;2015-01-30;CLI00044;FACTURA;37;1;285080;54165;339245
FAC0032694;2015-07-25;CLI00196;FACTURA;10;1;66381;12612;78993
FAC0032695;2015-10-01;CLI00603;FACTURA;21;2;94830;18018;112848
FAC0032696;2015-07-13;CLI00566;FACTURA;5;1;39012;7412;46424
FAC0032697;2015-05-29;CLI00976;FACTURA;29;1;40804;7753;48557
FAC0032698;2015-08-03;CLI00866;FACTURA;7;1;21859;4153;26012
FAC0032699;2015-12-07;CLI00778;FACTURA;19;1;28338;5384;33722
FAC0032700;2015-04-10;CLI00274;FACTURA;24;1;160111;30421;190532
FAC0032701;2015-10-21;CLI00738;FACTURA;25;1;50812;9654;60466
FAC0032702;2015-07-13;CLI00192;FACTURA;13;1;42820;8136;50956
FAC0032703;2015-11-11;CLI00106;FACTURA;43;1;228730;43459;272189
FAC0032704;2015-05-13;CLI00826;FACTURA;23;1;224888;42729;267617
FAC0032705;2015-12-29;CLI00135;FACTURA;24;2;143340;27235;170575
FAC0032706;2015-10-15;CLI00125;FACTURA;13;2;20292;3855;24147
FAC0032707;2015-12-15;CLI00590;FACTURA;38;1;109392;20784;130176
FAC0032708;2015-10-08;CLI00407;FACTURA;45;2;56898;10811;67709
FAC0032709;2015-06-19;CLI00178;FACTURA;43;1;63568;12078;75646
FAC0032710;2015-06-01;CLI00235;FACTURA;10;2;37932;7207;45139
FAC0032711;2015-05-26;CLI00640;FACTURA;33;1;43190;8206;51396
FAC0032712;2015-10-05;CLI00234;FACTURA;32;1;27348;5196;32544
FAC0032713;2015-11-16;CLI00228;FACTURA;50;1;80588;15312;95900
FAC0032714;2015-04-06;CLI00809;FACTURA;44;2;118454;22506;140960
FAC0032715;2015-06-24;CLI00785;FACTURA;19;2;128280;24373;152653
FAC0032716;2015-12-03;CLI00833;FACTURA;18;2;228654;43444;272098
FAC0032717;2015-11-24;CLI00159;FACTURA;49;2;71670;13617;85287
FAC0032718;2015-10-17;CLI00626;FACTURA;44;1;19506;3706;23212
FAC0032719;2015-04-24;CLI00882;FACTURA;15;1;20147;3828;23975
FAC0032720;2015-10-02;CLI00517;FACTURA;7;2;110836;21059;131895
FAC0032721;2015-02-22;CLI00029;FACTURA;31;2;20343;3865;24208
FAC0032722;2015-07-28;CLI00073;FACTURA;26;2;277090;52647;329737
FAC0032723;2015-11-13;CLI00302;FACTURA;4;1;69420;13190;82610
FAC0032724;2015-06-16;CLI00054;FACTURA;16;1;261027;49595;310622
FAC0032725;2015-02-18;CLI00062;FACTURA;30;1;31437;5973;37410
FAC0032726;2015-03-02;CLI00712;FACTURA;1;1;208260;39569;247829
FAC0032727;2015-06-04;CLI00849;FACTURA;3;2;117036;22237;139273
FAC0032728;2015-10-21;CLI00780;FACTURA;5;1;218590;41532;260122
FAC0032729;2015-03-13;CLI00129;FACTURA;15;2;142401;27056;169457
FAC0032730;2015-07-31;CLI00561;FACTURA;5;2;52908;10053;62961
FAC0032731;2015-09-12;CLI00816;FACTURA;34;1;102010;19382;121392
FAC0032732;2015-07-19;CLI00776;FACTURA;9;1;111030;21096;132126
FAC0032733;2015-07-16;CLI00350;FACTURA;5;1;136215;25881;162096
FAC0032734;2015-05-10;CLI00185;FACTURA;21;2;61790;11740;73530
FAC0032735;2015-11-28;CLI00185;FACTURA;12;2;210970;40084;251054
FAC0032736;2015-05-02;CLI00874;FACTURA;1;1;141088;26807;167895
FAC0032737;2015-12-08;CLI00319;FACTURA;39;2;35751;6793;42544
FAC0032738;2015-07-24;CLI00187;FACTURA;29;2;208824;39677;248501
FAC0032739;2015-04-05;CLI00108;FACTURA;24;1;45746;8692;54438
FAC0032740;2015-11-27;CLI00133;FACTURA;23;2;45104;8570;53674
FAC0032741;2015-06-04;CLI00676;FACTURA;18;1;34187;6496;40683
FAC0032742;2015-05-06;CLI00841;FACTURA;10;2;71502;13585;85087
FAC0032743;2015-01-23;CLI00017;FACTURA;25;2;53166;10102;63268
FAC0032744;2015-07-14;CLI00788;FACTURA;9;1;307683;58460;366143
FAC0032745;2015-08-27;CLI00435;FACTURA;21;2;81168;15422;96590
FAC0032746;2015-12-04;CLI00312;FACTURA;29;1;126490;24033;150523
FAC0032747;2015-10-01;CLI00598;FACTURA;25;1;68724;13058;81782
FAC0032748;2015-10-26;CLI00933;FACTURA;12;2;181323;34451;215774
FAC0032749;2015-11-11;CLI00963;FACTURA;6;2;75568;14358;89926
FAC0032750;2015-09-01;CLI00286;FACTURA;38;1;23834;4528;28362
FAC0032751;2015-05-10;CLI00967;FACTURA;20;2;63291;12025;75316
FAC0032752;2015-06-09;CLI00777;FACTURA;35;2;47668;9057;56725
FAC0032753;2015-09-19;CLI00651;FACTURA;50;2;25298;4807;30105
FAC0032754;2015-02-07;CLI00818;FACTURA;14;1;35751;6793;42544
FAC0032755;2015-04-25;CLI00949;FACTURA;3;2;33828;6427;40255
FAC0032756;2015-05-09;CLI00097;FACTURA;31;2;82044;15588;97632
FAC0032757;2015-08-05;CLI00097;FACTURA;20;2;172291;32735;205026
FAC0032758;2015-07-21;CLI00499;FACTURA;3;2;129006;24511;153517
FAC0032759;2015-01-18;CLI00281;FACTURA;27;2;50730;9639;60369
FAC0032760;2015-12-12;CLI00657;FACTURA;20;2;163458;31057;194515
FAC0032761;2015-03-14;CLI00494;FACTURA;16;1;177648;33753;211401
FAC0032762;2015-04-04;CLI00196;FACTURA;26;1;203430;38652;242082
FAC0032763;2015-07-10;CLI00464;FACTURA;17;1;313236;59515;372751
FAC0032764;2015-07-28;CLI00701;FACTURA;5;2;33828;6427;40255
FAC0032765;2015-05-27;CLI00617;FACTURA;5;2;84333;16023;100356
FAC0032766;2015-06-12;CLI00672;FACTURA;23;1;272430;51762;324192
FAC0032767;2015-01-10;CLI00392;FACTURA;42;1;28508;5417;33925
FAC0032768;2015-11-17;CLI00548;FACTURA;48;1;16136;3066;19202
FAC0032769;2015-03-13;CLI00326;FACTURA;31;1;27243;5176;32419
FAC0032770;2015-11-10;CLI00341;FACTURA;40;2;101892;19359;121251
FAC0032771;2015-08-28;CLI00283;FACTURA;4;2;50812;9654;60466
FAC0032772;2015-04-11;CLI00176;FACTURA;27;1;143340;27235;170575
FAC0032773;2015-05-17;CLI00408;FACTURA;23;1;33792;6420;40212
FAC0032774;2015-03-21;CLI00051;FACTURA;24;2;37794;7181;44975
FAC0032775;2015-04-02;CLI00396;FACTURA;21;1;203430;38652;242082
FAC0032776;2015-05-10;CLI00301;FACTURA;10;2;65577;12460;78037
FAC0032777;2015-09-14;CLI00245;FACTURA;2;2;211170;40122;251292
FAC0032778;2015-12-15;CLI00100;FACTURA;2;1;49226;9353;58579
FAC0032779;2015-03-12;CLI00634;FACTURA;4;1;33844;6430;40274
FAC0032780;2015-04-14;CLI00923;FACTURA;26;2;161360;30658;192018
FAC0032781;2015-01-04;CLI00684;FACTURA;4;1;41916;7964;49880
FAC0032782;2015-09-26;CLI00078;FACTURA;34;1;268776;51067;319843
FAC0032783;2015-04-25;CLI00957;FACTURA;23;2;10201;1938;12139
FAC0032784;2015-04-20;CLI00734;FACTURA;21;1;81608;15506;97114
FAC0032785;2015-05-03;CLI00508;FACTURA;47;1;27243;5176;32419
FAC0032786;2015-04-17;CLI00186;FACTURA;42;1;29003;5511;34514
FAC0032787;2015-06-02;CLI00008;FACTURA;1;1;160111;30421;190532
FAC0032788;2015-11-09;CLI00266;FACTURA;43;1;94485;17952;112437
FAC0032789;2015-10-17;CLI00743;FACTURA;46;2;126582;24051;150633
FAC0032790;2015-05-12;CLI00708;FACTURA;5;1;227682;43260;270942
FAC0032791;2015-11-12;CLI00398;FACTURA;8;1;239247;45457;284704
FAC0032792;2015-08-27;CLI00964;FACTURA;10;1;28668;5447;34115
FAC0032793;2015-10-25;CLI00649;FACTURA;1;2;16914;3214;20128
FAC0032794;2015-07-17;CLI00119;FACTURA;26;2;39012;7412;46424
FAC0032795;2015-03-19;CLI00481;FACTURA;1;2;239247;45457;284704
FAC0032796;2015-11-15;CLI00539;FACTURA;29;2;48408;9198;57606
FAC0032797;2015-09-24;CLI00654;FACTURA;3;1;6179;1174;7353
FAC0032798;2015-12-24;CLI00006;FACTURA;11;1;68619;13038;81657
FAC0032799;2015-10-12;CLI00449;FACTURA;36;2;35272;6702;41974
FAC0032800;2015-02-17;CLI00905;FACTURA;15;2;18897;3590;22487
FAC0032801;2015-03-02;CLI00699;FACTURA;24;2;87220;16572;103792
FAC0032802;2015-12-06;CLI00952;FACTURA;33;1;163458;31057;194515
FAC0032803;2015-05-06;CLI00517;FACTURA;2;2;30603;5815;36418
FAC0032804;2015-10-16;CLI00546;FACTURA;15;1;197344;37495;234839
FAC0032805;2015-07-02;CLI00483;FACTURA;41;2;129006;24511;153517
FAC0032806;2015-10-22;CLI00213;FACTURA;4;2;135376;25721;161097
FAC0032807;2015-09-27;CLI00191;FACTURA;41;2;123452;23456;146908
FAC0032808;2015-07-26;CLI00255;FACTURA;28;2;239247;45457;284704
FAC0032809;2015-02-10;CLI00758;FACTURA;18;1;32766;6226;38992
FAC0032810;2015-04-07;CLI00495;FACTURA;21;2;104130;19785;123915
FAC0032811;2015-06-09;CLI00090;FACTURA;31;1;22908;4353;27261
FAC0032812;2015-12-12;CLI00412;FACTURA;32;1;76218;14481;90699
FAC0032813;2015-09-25;CLI00311;FACTURA;13;2;75588;14362;89950
FAC0032814;2015-05-07;CLI00134;FACTURA;10;1;116012;22042;138054
FAC0032815;2015-06-17;CLI00063;FACTURA;12;2;43610;8286;51896
FAC0032816;2015-08-02;CLI00176;FACTURA;21;1;142540;27083;169623
FAC0032817;2015-01-20;CLI00223;FACTURA;2;2;278432;52902;331334
FAC0032818;2015-06-12;CLI00002;FACTURA;46;1;63351;12037;75388
FAC0032819;2015-06-19;CLI00495;FACTURA;4;2;55418;10529;65947
FAC0032820;2015-07-02;CLI00687;FACTURA;7;2;196904;37412;234316
FAC0032821;2015-08-08;CLI00380;FACTURA;26;1;91314;17350;108664
FAC0032822;2015-04-13;CLI00458;FACTURA;26;1;128280;24373;152653
FAC0032823;2015-07-15;CLI00286;FACTURA;14;1;100735;19140;119875
FAC0032824;2015-10-26;CLI00092;FACTURA;30;1;64230;12204;76434
FAC0032825;2015-06-13;CLI00711;FACTURA;17;2;25473;4840;30313
FAC0032826;2015-10-31;CLI00118;FACTURA;18;1;109025;20715;129740
FAC0032827;2015-02-17;CLI00975;FACTURA;44;2;252999;48070;301069
FAC0032828;2015-08-27;CLI00585;FACTURA;29;2;59585;11321;70906
FAC0032829;2015-01-29;CLI00602;FACTURA;10;1;32766;6226;38992
FAC0032830;2015-03-17;CLI00857;FACTURA;19;2;58006;11021;69027
FAC0032831;2015-07-11;CLI00004;FACTURA;25;1;212664;40406;253070
FAC0032832;2015-06-20;CLI00968;FACTURA;8;1;25406;4827;30233
FAC0032833;2015-12-09;CLI00936;FACTURA;48;1;50812;9654;60466
FAC0032834;2015-06-04;CLI00622;FACTURA;41;1;32766;6226;38992
FAC0032835;2015-03-25;CLI00481;FACTURA;7;2;60441;11484;71925
FAC0032836;2015-07-15;CLI00516;FACTURA;20;1;66122;12563;78685
FAC0032837;2015-08-31;CLI00753;FACTURA;50;2;14334;2723;17057
FAC0032838;2015-12-04;CLI00991;FACTURA;30;2;169220;32152;201372
FAC0032839;2015-05-03;CLI00704;FACTURA;38;1;10146;1928;12074
FAC0032840;2015-03-13;CLI00766;FACTURA;41;1;294894;56030;350924
FAC0032841;2015-10-02;CLI00972;FACTURA;33;1;56676;10768;67444
FAC0032842;2015-08-13;CLI00678;FACTURA;34;1;174440;33144;207584
FAC0032843;2015-06-02;CLI00573;FACTURA;46;2;13674;2598;16272
FAC0032844;2015-09-10;CLI00134;FACTURA;41;1;71670;13617;85287
FAC0032845;2015-12-25;CLI00019;FACTURA;8;2;214100;40679;254779
FAC0032846;2015-10-05;CLI00796;FACTURA;49;1;64140;12187;76327
FAC0032847;2015-02-12;CLI00799;FACTURA;9;2;216568;41148;257716
FAC0032848;2015-01-20;CLI00214;FACTURA;11;1;30603;5815;36418
FAC0032849;2015-03-28;CLI00219;FACTURA;19;2;142401;27056;169457
FAC0032850;2015-03-07;CLI00363;FACTURA;4;2;173550;32975;206525
FAC0032851;2015-02-09;CLI00364;FACTURA;12;1;168776;32067;200843
FAC0032852;2015-07-05;CLI00575;FACTURA;4;2;122058;23191;145249
FAC0032853;2015-07-26;CLI00327;FACTURA;32;2;58006;11021;69027
FAC0032854;2015-02-26;CLI00024;FACTURA;8;1;80588;15312;95900
FAC0032855;2015-06-19;CLI00256;FACTURA;32;1;127030;24136;151166
FAC0032856;2015-10-13;CLI00194;FACTURA;38;1;113195;21507;134702
FAC0032857;2015-02-16;CLI00853;FACTURA;44;2;83419;15850;99269
FAC0032858;2015-06-08;CLI00359;FACTURA;23;2;109025;20715;129740
FAC0032859;2015-05-07;CLI00972;FACTURA;44;1;133236;25315;158551
FAC0032860;2015-12-08;CLI00295;FACTURA;1;2;112444;21364;133808
FAC0032861;2015-04-10;CLI00587;FACTURA;27;2;189497;36004;225501
FAC0032862;2015-06-01;CLI00640;FACTURA;34;1;135355;25717;161072
FAC0032863;2015-12-29;CLI00281;FACTURA;6;2;67917;12904;80821
FAC0032864;2015-04-05;CLI00284;FACTURA;39;1;52908;10053;62961
FAC0032865;2015-07-02;CLI00377;FACTURA;13;2;168936;32098;201034
FAC0032866;2015-06-19;CLI00944;FACTURA;48;1;55418;10529;65947
FAC0032867;2015-10-17;CLI00886;FACTURA;1;1;71022;13494;84516
FAC0032868;2015-02-24;CLI00742;FACTURA;28;1;28338;5384;33722
FAC0032869;2015-08-07;CLI00004;FACTURA;47;1;81213;15430;96643
FAC0032870;2015-11-19;CLI00080;FACTURA;25;1;196596;37353;233949
FAC0032871;2015-11-25;CLI00583;FACTURA;24;2;183087;34787;217874
FAC0032872;2015-09-15;CLI00284;FACTURA;12;1;42240;8026;50266
FAC0032873;2015-11-13;CLI00674;FACTURA;30;1;152436;28963;181399
FAC0032874;2015-07-23;CLI00403;FACTURA;37;2;145015;27553;172568
FAC0032875;2015-02-26;CLI00314;FACTURA;44;1;41916;7964;49880
FAC0032876;2015-07-22;CLI00773;FACTURA;37;2;50730;9639;60369
FAC0032877;2015-03-04;CLI00906;FACTURA;13;1;138840;26380;165220
FAC0032878;2015-02-02;CLI00038;FACTURA;25;1;96816;18395;115211
FAC0032879;2015-10-17;CLI00705;FACTURA;37;2;33597;6383;39980
FAC0032880;2015-12-25;CLI00609;FACTURA;34;2;205122;38973;244095
FAC0032881;2015-10-12;CLI00795;FACTURA;8;2;16914;3214;20128
FAC0032882;2015-04-11;CLI00554;FACTURA;18;1;84610;16076;100686
FAC0032883;2015-11-10;CLI00603;FACTURA;9;2;261027;49595;310622
FAC0032884;2015-05-06;CLI00239;FACTURA;4;2;181112;34411;215523
FAC0032885;2015-01-13;CLI00420;FACTURA;10;1;13674;2598;16272
FAC0032886;2015-02-18;CLI00960;FACTURA;32;1;66122;12563;78685
FAC0032887;2015-08-13;CLI00361;FACTURA;44;2;68370;12990;81360
FAC0032888;2015-06-14;CLI00427;FACTURA;21;2;26583;5051;31634
FAC0032889;2015-08-20;CLI00087;FACTURA;7;2;42194;8017;50211
FAC0032890;2015-11-17;CLI00480;FACTURA;46;1;40294;7656;47950
FAC0032891;2015-08-12;CLI00105;FACTURA;42;2;162426;30861;193287
FAC0032892;2015-12-08;CLI00409;FACTURA;3;2;45104;8570;53674
FAC0032893;2015-10-14;CLI00007;FACTURA;50;2;76419;14520;90939
FAC0032894;2015-09-05;CLI00763;FACTURA;46;2;24668;4687;29355
FAC0032895;2015-05-19;CLI00153;FACTURA;25;2;114365;21729;136094
FAC0032896;2015-07-18;CLI00530;FACTURA;11;1;102010;19382;121392
FAC0032897;2015-03-08;CLI00345;FACTURA;35;2;120882;22968;143850
FAC0032898;2015-07-18;CLI00844;FACTURA;27;1;95718;18186;113904
FAC0032899;2015-08-26;CLI00115;FACTURA;35;2;348040;66128;414168
FAC0032900;2015-06-02;CLI00161;FACTURA;41;2;18966;3604;22570
FAC0032901;2015-07-17;CLI00482;FACTURA;10;1;127365;24199;151564
FAC0032902;2015-06-12;CLI00247;FACTURA;7;2;75568;14358;89926
FAC0032903;2015-07-27;CLI00659;FACTURA;39;2;24716;4696;29412
FAC0032904;2015-04-21;CLI00293;FACTURA;4;2;9483;1802;11285
FAC0032905;2015-01-31;CLI00231;FACTURA;16;2;166254;31588;197842
FAC0032906;2015-11-24;CLI00764;FACTURA;2;1;151176;28723;179899
FAC0032907;2015-10-01;CLI00641;FACTURA;17;2;176360;33508;209868
FAC0032908;2015-12-05;CLI00908;FACTURA;3;1;63291;12025;75316
FAC0032909;2015-02-07;CLI00111;FACTURA;36;2;54142;10287;64429
FAC0032910;2015-10-21;CLI00775;FACTURA;8;2;177842;33790;211632
FAC0032911;2015-08-19;CLI00722;FACTURA;17;1;32272;6132;38404
FAC0032912;2015-08-31;CLI00794;FACTURA;14;1;65577;12460;78037
FAC0032913;2015-03-30;CLI00916;FACTURA;35;1;163458;31057;194515
FAC0032914;2015-10-14;CLI00980;FACTURA;29;1;50688;9631;60319
FAC0032915;2015-12-24;CLI00976;FACTURA;43;1;199854;37972;237826
FAC0032916;2015-05-03;CLI00370;FACTURA;12;1;102561;19487;122048
FAC0032917;2015-10-10;CLI00218;FACTURA;30;1;80588;15312;95900
FAC0032918;2015-07-05;CLI00107;FACTURA;46;2;25344;4815;30159
FAC0032919;2015-09-25;CLI00816;FACTURA;20;1;307683;58460;366143
FAC0032920;2015-03-20;CLI00676;FACTURA;37;1;98452;18706;117158
FAC0032921;2015-05-24;CLI00945;FACTURA;1;2;41916;7964;49880
FAC0032922;2015-11-08;CLI00715;FACTURA;19;2;84333;16023;100356
FAC0032923;2015-06-18;CLI00718;FACTURA;13;1;18966;3604;22570
FAC0032924;2015-10-11;CLI00073;FACTURA;40;2;69420;13190;82610
FAC0032925;2015-11-03;CLI00248;FACTURA;24;1;123065;23382;146447
FAC0032926;2015-10-16;CLI00528;FACTURA;49;1;203751;38713;242464
FAC0032927;2015-05-12;CLI00699;FACTURA;17;2;107253;20378;127631
FAC0032928;2015-08-21;CLI00730;FACTURA;50;1;25298;4807;30105
FAC0032929;2015-04-16;CLI00021;FACTURA;44;2;104790;19910;124700
FAC0032930;2015-06-09;CLI00505;FACTURA;16;2;101715;19326;121041
FAC0032931;2015-12-01;CLI00498;FACTURA;10;1;10201;1938;12139
FAC0032932;2015-12-09;CLI00972;FACTURA;6;1;56898;10811;67709
FAC0032933;2015-03-28;CLI00897;FACTURA;14;2;54486;10352;64838
FAC0032934;2015-02-28;CLI00912;FACTURA;19;1;56222;10682;66904
FAC0032935;2015-08-17;CLI00353;FACTURA;21;2;28449;5405;33854
FAC0032936;2015-08-16;CLI00944;FACTURA;25;1;39466;7499;46965
FAC0032937;2015-10-14;CLI00904;FACTURA;38;1;81372;15461;96833
FAC0032938;2015-11-03;CLI00458;FACTURA;39;1;104130;19785;123915
FAC0032939;2015-01-10;CLI00421;FACTURA;12;2;348040;66128;414168
FAC0032940;2015-05-30;CLI00799;FACTURA;44;2;71022;13494;84516
FAC0032941;2015-03-06;CLI00840;FACTURA;17;1;39466;7499;46965
FAC0032942;2015-11-08;CLI00150;FACTURA;11;1;211170;40122;251292
FAC0032943;2015-10-13;CLI00678;FACTURA;28;1;58518;11118;69636
FAC0032944;2015-04-30;CLI00417;FACTURA;17;2;186081;35355;221436
FAC0032945;2015-07-21;CLI00367;FACTURA;32;2;68619;13038;81657
FAC0032946;2015-11-26;CLI00753;FACTURA;7;2;40294;7656;47950
FAC0032947;2015-05-31;CLI00308;FACTURA;2;1;27071;5143;32214
FAC0032948;2015-05-23;CLI00025;FACTURA;31;2;30895;5870;36765
FAC0032949;2015-07-03;CLI00240;FACTURA;33;1;143340;27235;170575
FAC0032950;2015-03-21;CLI00113;FACTURA;40;2;160350;30467;190817
FAC0032951;2015-06-10;CLI00735;FACTURA;28;2;18510;3517;22027
FAC0032952;2015-05-14;CLI00764;FACTURA;29;1;123065;23382;146447
FAC0032953;2015-12-16;CLI00537;FACTURA;49;2;120882;22968;143850
FAC0032954;2015-07-29;CLI00924;FACTURA;14;1;96210;18280;114490
FAC0032955;2015-12-10;CLI00826;FACTURA;22;1;14334;2723;17057
FAC0032956;2015-01-26;CLI00657;FACTURA;2;2;94460;17947;112407
FAC0032957;2015-03-05;CLI00308;FACTURA;29;1;68724;13058;81782
FAC0032958;2015-02-21;CLI00593;FACTURA;17;2;54142;10287;64429
FAC0032959;2015-07-06;CLI00192;FACTURA;15;1;123066;23383;146449
FAC0032960;2015-12-07;CLI00848;FACTURA;18;1;39466;7499;46965
FAC0032961;2015-05-31;CLI00196;FACTURA;1;1;197344;37495;234839
FAC0032962;2015-05-31;CLI00907;FACTURA;36;2;152298;28937;181235
FAC0032963;2015-09-15;CLI00949;FACTURA;49;2;109025;20715;129740
FAC0032964;2015-09-21;CLI00505;FACTURA;11;2;34710;6595;41305
FAC0032965;2015-09-01;CLI00032;FACTURA;37;1;33597;6383;39980
FAC0032966;2015-12-29;CLI00405;FACTURA;8;2;32070;6093;38163
FAC0032967;2015-02-23;CLI00742;FACTURA;37;1;10479;1991;12470
FAC0032968;2015-09-18;CLI00016;FACTURA;50;1;85640;16272;101912
FAC0032969;2015-09-03;CLI00734;FACTURA;15;1;43190;8206;51396
FAC0032970;2015-02-09;CLI00645;FACTURA;19;2;161176;30623;191799
FAC0032971;2015-05-12;CLI00924;FACTURA;30;1;129088;24527;153615
FAC0032972;2015-09-20;CLI00582;FACTURA;41;1;84388;16034;100422
FAC0032973;2015-04-19;CLI01000;FACTURA;13;1;79749;15152;94901
FAC0032974;2015-01-11;CLI00902;FACTURA;16;1;173550;32975;206525
FAC0032975;2015-02-06;CLI00219;FACTURA;17;2;50730;9639;60369
FAC0032976;2015-03-12;CLI00871;FACTURA;28;2;161360;30658;192018
FAC0032977;2015-11-04;CLI00386;FACTURA;3;1;71407;13567;84974
FAC0032978;2015-10-05;CLI00055;FACTURA;31;2;119170;22642;141812
FAC0032979;2015-05-28;CLI00668;FACTURA;46;1;151176;28723;179899
FAC0032980;2015-06-13;CLI00805;FACTURA;20;2;94830;18018;112848
FAC0032981;2015-09-12;CLI00182;FACTURA;14;1;34362;6529;40891
FAC0032982;2015-08-25;CLI00462;FACTURA;49;1;158473;30110;188583
FAC0032983;2015-07-04;CLI00301;FACTURA;39;2;183087;34787;217874
FAC0032984;2015-11-08;CLI00335;FACTURA;46;2;158724;30158;188882
FAC0032985;2015-03-02;CLI00947;FACTURA;1;2;174872;33226;208098
FAC0032986;2015-08-13;CLI00585;FACTURA;39;2;152635;29001;181636
FAC0032987;2015-04-20;CLI00703;FACTURA;43;2;235179;44684;279863
FAC0032988;2015-11-04;CLI00217;FACTURA;38;2;145015;27553;172568
FAC0032989;2015-09-20;CLI00496;FACTURA;17;1;100735;19140;119875
FAC0032990;2015-11-07;CLI00289;FACTURA;10;2;159498;30305;189803
FAC0032991;2015-04-29;CLI00835;FACTURA;40;2;254730;48399;303129
FAC0032992;2015-10-13;CLI00206;FACTURA;43;1;131154;24919;156073
FAC0032993;2015-05-05;CLI00514;FACTURA;28;1;85524;16250;101774
FAC0032994;2015-01-27;CLI00395;FACTURA;46;2;151176;28723;179899
FAC0032995;2015-08-18;CLI00053;FACTURA;30;2;181323;34451;215774
FAC0032996;2015-12-22;CLI00015;FACTURA;49;2;181112;34411;215523
FAC0032997;2015-11-11;CLI00477;FACTURA;27;2;136748;25982;162730
FAC0032998;2015-11-01;CLI00743;FACTURA;1;2;313236;59515;372751
FAC0032999;2015-06-03;CLI00866;FACTURA;45;1;40804;7753;48557
FAC0033000;2015-10-19;CLI00111;FACTURA;7;2;158473;30110;188583
FAC0033001;2015-05-29;CLI00133;FACTURA;46;2;105485;20042;125527
FAC0033002;2015-02-07;CLI00678;FACTURA;5;1;48105;9140;57245
FAC0033003;2015-03-11;CLI00552;FACTURA;37;1;52908;10053;62961
FAC0033004;2015-12-19;CLI00377;FACTURA;6;2;136748;25982;162730
FAC0033005;2015-11-25;CLI00603;FACTURA;20;2;177842;33790;211632
FAC0033006;2015-12-27;CLI00853;FACTURA;26;2;178311;33879;212190
FAC0033007;2015-12-15;CLI00827;FACTURA;9;2;190053;36110;226163
FAC0033008;2015-08-16;CLI00820;FACTURA;45;1;139216;26451;165667
FAC0033009;2015-03-17;CLI00606;FACTURA;36;1;116012;22042;138054
FAC0033010;2015-02-09;CLI00989;FACTURA;3;2;151788;28840;180628
FAC0033011;2015-09-24;CLI00272;FACTURA;41;1;64544;12263;76807
FAC0033012;2015-12-23;CLI00535;FACTURA;33;2;54696;10392;65088
FAC0033013;2015-03-28;CLI00220;FACTURA;10;1;13674;2598;16272
FAC0033014;2015-02-19;CLI00222;FACTURA;7;1;32766;6226;38992
FAC0033015;2015-08-31;CLI00953;FACTURA;31;2;63291;12025;75316
FAC0033016;2015-09-15;CLI00714;FACTURA;15;1;129088;24527;153615
FAC0033017;2015-08-11;CLI00269;FACTURA;15;2;98672;18748;117420
FAC0033018;2015-01-27;CLI00739;FACTURA;9;2;141029;26796;167825
FAC0033019;2015-10-05;CLI00093;FACTURA;49;2;80680;15329;96009
FAC0033020;2015-05-15;CLI00283;FACTURA;18;2;172676;32808;205484
FAC0033021;2015-05-28;CLI00488;FACTURA;42;1;45746;8692;54438
FAC0033022;2015-10-19;CLI00628;FACTURA;39;1;22206;4219;26425
FAC0033023;2015-05-20;CLI00443;FACTURA;24;2;21097;4008;25105
FAC0033024;2015-08-20;CLI00035;FACTURA;21;2;30850;5862;36712
FAC0033025;2015-06-10;CLI00213;FACTURA;30;2;123065;23382;146447
FAC0033026;2015-09-17;CLI00462;FACTURA;21;1;62874;11946;74820
FAC0033027;2015-05-16;CLI00921;FACTURA;24;2;50946;9680;60626
FAC0033028;2015-04-27;CLI00526;FACTURA;47;1;128460;24407;152867
FAC0033029;2015-10-05;CLI00617;FACTURA;5;2;168666;32047;200713
FAC0033030;2015-02-08;CLI00984;FACTURA;8;1;39466;7499;46965
FAC0033031;2015-03-28;CLI00233;FACTURA;36;2;18892;3589;22481
FAC0033032;2015-05-09;CLI00469;FACTURA;33;2;96210;18280;114490
FAC0033033;2015-01-21;CLI00640;FACTURA;23;1;103086;19586;122672
FAC0033034;2015-11-15;CLI00371;FACTURA;37;2;136748;25982;162730
FAC0033035;2015-11-16;CLI00166;FACTURA;30;1;18892;3589;22481
FAC0033036;2015-10-21;CLI00422;FACTURA;33;1;189497;36004;225501
FAC0033037;2015-01-14;CLI00361;FACTURA;15;2;8448;1605;10053
FAC0033038;2015-10-13;CLI00820;FACTURA;45;1;12358;2348;14706
FAC0033039;2015-06-03;CLI00305;FACTURA;47;2;114032;21666;135698
FAC0033040;2015-11-07;CLI00760;FACTURA;29;1;313236;59515;372751
FAC0033041;2015-02-17;CLI00354;FACTURA;1;1;163458;31057;194515
FAC0033042;2015-05-28;CLI00021;FACTURA;40;2;123065;23382;146447
FAC0033043;2015-01-17;CLI00599;FACTURA;26;2;37932;7207;45139
FAC0033044;2015-04-06;CLI00227;FACTURA;34;2;55611;10566;66177
FAC0033045;2015-06-15;CLI00723;FACTURA;18;2;25298;4807;30105
FAC0033046;2015-01-28;CLI00728;FACTURA;41;1;35272;6702;41974
FAC0033047;2015-02-06;CLI00832;FACTURA;4;1;76419;14520;90939
FAC0033048;2015-04-02;CLI00200;FACTURA;39;1;73353;13937;87290
FAC0033049;2015-03-09;CLI00247;FACTURA;44;2;256572;48749;305321
FAC0033050;2015-02-07;CLI00336;FACTURA;24;1;30438;5783;36221
FAC0033051;2015-01-17;CLI00677;FACTURA;21;2;6179;1174;7353
FAC0033052;2015-04-04;CLI00208;FACTURA;40;1;28508;5417;33925
FAC0033053;2015-08-08;CLI00052;FACTURA;40;1;243628;46289;289917
FAC0033054;2015-02-11;CLI00133;FACTURA;45;2;12340;2345;14685
FAC0033055;2015-10-17;CLI00593;FACTURA;35;2;66122;12563;78685
FAC0033056;2015-06-24;CLI00301;FACTURA;17;2;65577;12460;78037
FAC0033057;2015-02-05;CLI00856;FACTURA;20;1;42240;8026;50266
FAC0033058;2015-11-06;CLI00111;FACTURA;10;2;25473;4840;30313
FAC0033059;2015-10-02;CLI00793;FACTURA;11;2;55418;10529;65947
FAC0033060;2015-02-06;CLI00388;FACTURA;49;1;189497;36004;225501
FAC0033061;2015-03-28;CLI00467;FACTURA;5;2;85524;16250;101774
FAC0033062;2015-08-15;CLI00571;FACTURA;20;2;20402;3876;24278
FAC0033063;2015-06-19;CLI00997;FACTURA;13;2;23838;4529;28367
FAC0033064;2015-12-16;CLI00249;FACTURA;21;2;61700;11723;73423
FAC0033065;2015-04-05;CLI00021;FACTURA;10;2;151788;28840;180628
FAC0033066;2015-11-11;CLI00085;FACTURA;8;2;51005;9691;60696
FAC0033067;2015-10-12;CLI00695;FACTURA;19;2;348040;66128;414168
FAC0033068;2015-05-12;CLI00389;FACTURA;8;2;10146;1928;12074
FAC0033069;2015-11-19;CLI00266;FACTURA;49;1;158724;30158;188882
FAC0033070;2015-08-04;CLI00541;FACTURA;9;2;47230;8974;56204
FAC0033071;2015-04-01;CLI00410;FACTURA;41;1;23838;4529;28367
FAC0033072;2015-06-09;CLI00975;FACTURA;8;2;216568;41148;257716
FAC0033073;2015-03-08;CLI00324;FACTURA;26;1;66381;12612;78993
FAC0033074;2015-01-28;CLI00151;FACTURA;28;2;25473;4840;30313
FAC0033075;2015-04-29;CLI00758;FACTURA;39;1;136542;25943;162485
FAC0033076;2015-06-01;CLI00139;FACTURA;48;2;9483;1802;11285
FAC0033077;2015-12-22;CLI00906;FACTURA;48;1;218590;41532;260122
FAC0033078;2015-08-27;CLI00742;FACTURA;47;1;100791;19150;119941
FAC0033079;2015-07-07;CLI00414;FACTURA;40;1;134388;25534;159922
FAC0033080;2015-06-10;CLI00091;FACTURA;11;2;24680;4689;29369
FAC0033081;2015-03-12;CLI00270;FACTURA;12;1;218050;41430;259480
FAC0033082;2015-07-17;CLI00180;FACTURA;38;1;67688;12861;80549
FAC0033083;2015-07-20;CLI00033;FACTURA;15;2;6170;1172;7342
FAC0033084;2015-03-14;CLI00679;FACTURA;2;2;22908;4353;27261
FAC0033085;2015-10-04;CLI00672;FACTURA;27;1;34710;6595;41305
FAC0033086;2015-11-28;CLI00344;FACTURA;34;1;116012;22042;138054
FAC0033087;2015-06-26;CLI00255;FACTURA;9;2;96210;18280;114490
FAC0033088;2015-03-13;CLI00361;FACTURA;34;2;196904;37412;234316
FAC0033089;2015-06-18;CLI00392;FACTURA;22;1;7946;1510;9456
FAC0033090;2015-10-17;CLI00280;FACTURA;19;1;20147;3828;23975
FAC0033091;2015-05-18;CLI00727;FACTURA;17;2;94485;17952;112437
FAC0033092;2015-09-01;CLI00822;FACTURA;30;1;34362;6529;40891
FAC0033093;2015-07-28;CLI00578;FACTURA;39;1;100735;19140;119875
FAC0033094;2015-10-08;CLI00951;FACTURA;9;2;114032;21666;135698
FAC0033095;2015-03-30;CLI00271;FACTURA;1;2;102561;19487;122048
FAC0033096;2015-01-13;CLI00122;FACTURA;29;1;58006;11021;69027
FAC0033097;2015-12-20;CLI00844;FACTURA;47;1;16914;3214;20128
FAC0033098;2015-05-11;CLI00608;FACTURA;47;1;254730;48399;303129
FAC0033099;2015-01-15;CLI00628;FACTURA;8;1;30895;5870;36765
FAC0033100;2015-04-11;CLI00340;FACTURA;16;1;203248;38617;241865
FAC0033101;2015-12-28;CLI00015;FACTURA;44;2;95336;18114;113450
FAC0033102;2015-04-03;CLI00188;FACTURA;36;1;28111;5341;33452
FAC0033103;2015-05-09;CLI00600;FACTURA;3;1;176360;33508;209868
FAC0033104;2015-08-30;CLI00015;FACTURA;8;2;45746;8692;54438
FAC0033105;2015-08-18;CLI00678;FACTURA;29;1;160111;30421;190532
FAC0033106;2015-09-02;CLI00944;FACTURA;49;1;135355;25717;161072
FAC0033107;2015-03-31;CLI00492;FACTURA;32;1;196731;37379;234110
FAC0033108;2015-08-03;CLI00208;FACTURA;9;1;68724;13058;81782
FAC0033109;2015-07-24;CLI00060;FACTURA;49;1;201582;38301;239883
FAC0033110;2015-06-22;CLI00055;FACTURA;18;2;123065;23382;146447
FAC0033111;2015-02-12;CLI00453;FACTURA;14;2;161360;30658;192018
FAC0033112;2015-04-23;CLI00687;FACTURA;49;2;54142;10287;64429
FAC0033113;2015-10-15;CLI00985;FACTURA;3;2;221517;42088;263605
FAC0033114;2015-05-11;CLI00924;FACTURA;39;1;197344;37495;234839
FAC0033115;2015-03-27;CLI00831;FACTURA;38;2;65415;12429;77844
FAC0033116;2015-03-15;CLI00881;FACTURA;21;2;16914;3214;20128
FAC0033117;2015-04-10;CLI00387;FACTURA;50;2;197344;37495;234839
FAC0033118;2015-09-20;CLI00567;FACTURA;8;2;33792;6420;40212
FAC0033119;2015-03-16;CLI00945;FACTURA;40;2;228064;43332;271396
FAC0033120;2015-06-03;CLI00201;FACTURA;50;2;137238;26075;163313
FAC0033121;2015-03-02;CLI00868;FACTURA;15;1;39466;7499;46965
FAC0033122;2015-06-23;CLI00145;FACTURA;50;2;127030;24136;151166
FAC0033123;2015-01-21;CLI00709;FACTURA;40;2;28111;5341;33452
FAC0033124;2015-02-14;CLI00355;FACTURA;46;2;171048;32499;203547
FAC0033125;2015-06-07;CLI00565;FACTURA;19;2;145015;27553;172568
FAC0033126;2015-03-13;CLI00977;FACTURA;41;2;97530;18531;116061
FAC0033127;2015-01-26;CLI00806;FACTURA;26;1;129006;24511;153517
FAC0033128;2015-03-16;CLI00234;FACTURA;34;1;83832;15928;99760
FAC0033129;2015-01-28;CLI00678;FACTURA;40;1;55530;10551;66081
FAC0033130;2015-08-21;CLI00596;FACTURA;32;1;84480;16051;100531
FAC0033131;2015-12-18;CLI00954;FACTURA;11;1;312390;59354;371744
FAC0033132;2015-03-12;CLI00335;FACTURA;49;2;166254;31588;197842
FAC0033133;2015-11-12;CLI00570;FACTURA;1;1;16922;3215;20137
FAC0033134;2015-09-13;CLI00971;FACTURA;47;2;37932;7207;45139
FAC0033135;2015-02-14;CLI00647;FACTURA;32;2;11917;2264;14181
FAC0033136;2015-03-18;CLI00969;FACTURA;29;2;43718;8306;52024
FAC0033137;2015-02-07;CLI00467;FACTURA;47;2;79460;15097;94557
FAC0033138;2015-08-24;CLI00481;FACTURA;11;2;48408;9198;57606
FAC0033139;2015-01-23;CLI00109;FACTURA;22;2;87009;16532;103541
FAC0033140;2015-05-16;CLI00714;FACTURA;13;1;100338;19064;119402
FAC0033141;2015-09-07;CLI00932;FACTURA;9;1;24716;4696;29412
FAC0033142;2015-02-05;CLI00623;FACTURA;29;2;108284;20574;128858
FAC0033143;2015-07-31;CLI00285;FACTURA;29;2;54142;10287;64429
FAC0033144;2015-08-19;CLI00621;FACTURA;38;2;101192;19226;120418
FAC0033145;2015-05-09;CLI00445;FACTURA;29;2;58006;11021;69027
FAC0033146;2015-01-22;CLI00458;FACTURA;47;1;61790;11740;73530
FAC0033147;2015-01-24;CLI00145;FACTURA;30;2;101532;19291;120823
FAC0033148;2015-09-14;CLI00923;FACTURA;46;2;66618;12657;79275
FAC0033149;2015-08-21;CLI00153;FACTURA;39;2;178311;33879;212190
FAC0033150;2015-01-09;CLI00289;FACTURA;44;2;62874;11946;74820
FAC0033151;2015-09-17;CLI00286;FACTURA;7;1;152838;29039;181877
FAC0033152;2015-07-25;CLI00163;FACTURA;14;2;82044;15588;97632
FAC0033153;2015-07-01;CLI00534;FACTURA;3;1;18537;3522;22059
FAC0033154;2015-06-22;CLI00848;FACTURA;33;1;55611;10566;66177
FAC0033155;2015-07-21;CLI00647;FACTURA;31;2;294894;56030;350924
FAC0033156;2015-01-04;CLI00706;FACTURA;2;1;196245;37287;233532
FAC0033157;2015-06-11;CLI00766;FACTURA;2;1;32070;6093;38163
FAC0033158;2015-05-19;CLI00539;FACTURA;42;2;177648;33753;211401
FAC0033159;2015-02-04;CLI00538;FACTURA;43;1;49336;9374;58710
FAC0033160;2015-05-28;CLI00245;FACTURA;27;2;65577;12460;78037
FAC0033161;2015-04-13;CLI00922;FACTURA;33;1;63351;12037;75388
FAC0033162;2015-08-21;CLI00996;FACTURA;10;1;201470;38279;239749
FAC0033163;2015-07-10;CLI00809;FACTURA;3;2;24613;4676;29289
FAC0033164;2015-08-09;CLI00131;FACTURA;39;2;203248;38617;241865
FAC0033165;2015-02-07;CLI00940;FACTURA;43;1;6179;1174;7353
FAC0033166;2015-03-05;CLI00675;FACTURA;15;2;17636;3351;20987
FAC0033167;2015-05-07;CLI00651;FACTURA;28;2;6179;1174;7353
FAC0033168;2015-04-17;CLI00502;FACTURA;35;1;83832;15928;99760
FAC0033169;2015-05-17;CLI00630;FACTURA;24;1;203751;38713;242464
FAC0033170;2015-12-29;CLI00940;FACTURA;21;1;203248;38617;241865
FAC0033171;2015-11-23;CLI00346;FACTURA;11;1;40294;7656;47950
FAC0033172;2015-04-09;CLI00024;FACTURA;13;1;139216;26451;165667
FAC0033173;2015-03-23;CLI00011;FACTURA;12;2;147678;28059;175737
FAC0033174;2015-09-24;CLI00902;FACTURA;4;1;196245;37287;233532
FAC0033175;2015-02-14;CLI00613;FACTURA;17;2;203784;38719;242503
FAC0033176;2015-07-16;CLI00564;FACTURA;36;1;20958;3982;24940
FAC0033177;2015-04-03;CLI00878;FACTURA;2;1;30895;5870;36765
FAC0033178;2015-02-18;CLI00208;FACTURA;4;1;5638;1071;6709
FAC0033179;2015-04-24;CLI00339;FACTURA;16;2;140555;26705;167260
FAC0033180;2015-02-04;CLI00730;FACTURA;37;1;63568;12078;75646
FAC0033181;2015-08-27;CLI00567;FACTURA;9;2;57270;10881;68151
FAC0033182;2015-02-28;CLI00475;FACTURA;19;2;16136;3066;19202
FAC0033183;2015-04-10;CLI00436;FACTURA;34;1;20292;3855;24147
FAC0033184;2015-01-04;CLI00954;FACTURA;31;1;62874;11946;74820
FAC0033185;2015-12-28;CLI00260;FACTURA;41;1;203430;38652;242082
FAC0033186;2015-02-11;CLI00639;FACTURA;23;2;37074;7044;44118
FAC0033187;2015-07-07;CLI00716;FACTURA;34;1;10201;1938;12139
FAC0033188;2015-08-18;CLI00933;FACTURA;14;2;114540;21763;136303
FAC0033189;2015-12-10;CLI00153;FACTURA;45;2;98298;18677;116975
FAC0033190;2015-07-25;CLI00504;FACTURA;25;1;56691;10771;67462
FAC0033191;2015-04-13;CLI00112;FACTURA;25;1;118454;22506;140960
FAC0033192;2015-08-05;CLI00298;FACTURA;41;1;272430;51762;324192
FAC0033193;2015-08-24;CLI00198;FACTURA;36;1;243639;46291;289930
FAC0033194;2015-11-10;CLI00524;FACTURA;26;1;73353;13937;87290
FAC0033195;2015-12-22;CLI00399;FACTURA;3;2;195060;37061;232121
FAC0033196;2015-08-10;CLI00287;FACTURA;25;2;168936;32098;201034
FAC0033197;2015-07-01;CLI00210;FACTURA;15;1;197344;37495;234839
FAC0033198;2015-03-25;CLI00390;FACTURA;11;1;45104;8570;53674
FAC0033199;2015-12-11;CLI00475;FACTURA;25;2;9446;1795;11241
FAC0033200;2015-05-09;CLI00738;FACTURA;23;1;84468;16049;100517
FAC0033201;2015-01-16;CLI00496;FACTURA;7;1;59585;11321;70906
FAC0033202;2015-11-26;CLI00869;FACTURA;7;2;113195;21507;134702
FAC0033203;2015-08-30;CLI00603;FACTURA;39;2;196731;37379;234110
FAC0033204;2015-08-11;CLI00987;FACTURA;8;2;45278;8603;53881
FAC0033205;2015-12-17;CLI00079;FACTURA;29;2;50766;9646;60412
FAC0033206;2015-03-12;CLI00660;FACTURA;50;1;67584;12841;80425
FAC0033207;2015-05-09;CLI00861;FACTURA;1;2;28508;5417;33925
FAC0033208;2015-09-25;CLI00230;FACTURA;49;1;54486;10352;64838
FAC0033209;2015-05-05;CLI00112;FACTURA;11;1;68724;13058;81782
FAC0033210;2015-04-14;CLI00036;FACTURA;26;1;8448;1605;10053
FAC0033211;2015-06-20;CLI00735;FACTURA;13;2;196904;37412;234316
FAC0033212;2015-05-23;CLI00071;FACTURA;22;2;68370;12990;81360
FAC0033213;2015-12-05;CLI00773;FACTURA;7;2;33828;6427;40255
FAC0033214;2015-01-31;CLI00080;FACTURA;12;1;9446;1795;11241
FAC0033215;2015-08-22;CLI00787;FACTURA;20;2;45816;8705;54521
FAC0033216;2015-12-06;CLI00556;FACTURA;31;1;98672;18748;117420
FAC0033217;2015-05-18;CLI00683;FACTURA;4;2;9446;1795;11241
FAC0033218;2015-05-05;CLI00789;FACTURA;25;2;199556;37916;237472
FAC0033219;2015-08-30;CLI00776;FACTURA;41;1;60441;11484;71925
FAC0033220;2015-07-17;CLI00556;FACTURA;11;1;232024;44085;276109
FAC0033221;2015-12-12;CLI00919;FACTURA;10;2;30603;5815;36418
FAC0033222;2015-07-31;CLI00874;FACTURA;28;1;122058;23191;145249
FAC0033223;2015-12-28;CLI00749;FACTURA;41;2;114032;21666;135698
FAC0033224;2015-02-22;CLI00760;FACTURA;8;1;170073;32314;202387
FAC0033225;2015-12-15;CLI00477;FACTURA;34;2;53166;10102;63268
FAC0033226;2015-10-05;CLI00587;FACTURA;26;2;28111;5341;33452
FAC0033227;2015-12-02;CLI00737;FACTURA;48;2;22873;4346;27219
FAC0033228;2015-05-10;CLI00750;FACTURA;4;1;80680;15329;96009
FAC0033229;2015-11-12;CLI00526;FACTURA;44;1;67688;12861;80549
FAC0033230;2015-01-30;CLI00542;FACTURA;12;1;62874;11946;74820
FAC0033231;2015-06-16;CLI00075;FACTURA;3;2;50766;9646;60412
FAC0033232;2015-04-12;CLI00202;FACTURA;12;1;19506;3706;23212
FAC0033233;2015-07-18;CLI00981;FACTURA;7;2;114672;21788;136460
FAC0033234;2015-05-05;CLI00375;FACTURA;45;2;132915;25254;158169
FAC0033235;2015-02-03;CLI00575;FACTURA;10;2;48105;9140;57245
FAC0033236;2015-09-20;CLI00837;FACTURA;11;2;76032;14446;90478
FAC0033237;2015-04-04;CLI00122;FACTURA;9;1;40804;7753;48557
FAC0033238;2015-03-19;CLI00148;FACTURA;13;1;70544;13403;83947
FAC0033239;2015-07-09;CLI00907;FACTURA;42;2;51005;9691;60696
FAC0033240;2015-07-27;CLI00343;FACTURA;22;2;16896;3210;20106
FAC0033241;2015-07-11;CLI00436;FACTURA;29;1;141029;26796;167825
FAC0033242;2015-08-30;CLI00664;FACTURA;27;1;54486;10352;64838
FAC0033243;2015-09-20;CLI00734;FACTURA;18;1;147678;28059;175737
FAC0033244;2015-07-13;CLI00384;FACTURA;2;1;73839;14029;87868
FAC0033245;2015-05-28;CLI00654;FACTURA;12;1;100338;19064;119402
FAC0033246;2015-10-17;CLI00580;FACTURA;7;1;28338;5384;33722
FAC0033247;2015-07-14;CLI00019;FACTURA;33;2;105816;20105;125921
FAC0033248;2015-01-05;CLI00305;FACTURA;31;2;107050;20340;127390
FAC0033249;2015-06-12;CLI00090;FACTURA;43;1;87436;16613;104049
FAC0033250;2015-10-02;CLI00153;FACTURA;44;2;203248;38617;241865
FAC0033251;2015-07-09;CLI00050;FACTURA;7;1;130830;24858;155688
FAC0033252;2015-06-12;CLI00285;FACTURA;5;2;136215;25881;162096
FAC0033253;2015-08-20;CLI00576;FACTURA;26;1;63351;12037;75388
FAC0033254;2015-10-15;CLI00103;FACTURA;16;2;16136;3066;19202
FAC0033255;2015-05-26;CLI00431;FACTURA;46;2;182984;34767;217751
FAC0033256;2015-03-23;CLI00351;FACTURA;26;2;166254;31588;197842
FAC0033257;2015-07-04;CLI00072;FACTURA;33;1;114365;21729;136094
FAC0033258;2015-06-14;CLI00188;FACTURA;46;1;173550;32975;206525
FAC0033259;2015-12-12;CLI00837;FACTURA;36;2;61790;11740;73530
FAC0033260;2015-02-05;CLI00407;FACTURA;29;2;28111;5341;33452
FAC0033261;2015-06-30;CLI00023;FACTURA;19;2;142401;27056;169457
FAC0033262;2015-12-14;CLI00921;FACTURA;19;2;24680;4689;29369
FAC0033263;2015-02-13;CLI00305;FACTURA;18;2;71022;13494;84516
FAC0033264;2015-04-21;CLI00358;FACTURA;20;1;327660;62255;389915
FAC0033265;2015-10-06;CLI00582;FACTURA;31;1;190053;36110;226163
FAC0033266;2015-03-04;CLI00844;FACTURA;40;1;63351;12037;75388
FAC0033267;2015-07-28;CLI00770;FACTURA;11;1;341870;64955;406825
FAC0033268;2015-10-02;CLI00209;FACTURA;39;2;84610;16076;100686
FAC0033269;2015-08-11;CLI00365;FACTURA;2;2;59585;11321;70906
FAC0033270;2015-09-06;CLI00678;FACTURA;8;1;22552;4285;26837
FAC0033271;2015-11-12;CLI00835;FACTURA;47;2;68619;13038;81657
FAC0033272;2015-10-24;CLI00361;FACTURA;45;2;214100;40679;254779
FAC0033273;2015-12-16;CLI00749;FACTURA;9;2;100338;19064;119402
FAC0033274;2015-04-23;CLI00814;FACTURA;30;1;87436;16613;104049
FAC0033275;2015-03-05;CLI00042;FACTURA;46;1;147678;28059;175737
FAC0033276;2015-09-02;CLI00747;FACTURA;14;2;47415;9009;56424
FAC0033277;2015-02-16;CLI00597;FACTURA;4;2;44412;8438;52850
FAC0033278;2015-09-01;CLI00394;FACTURA;9;1;50742;9641;60383
FAC0033279;2015-10-01;CLI00095;FACTURA;34;2;101532;19291;120823
FAC0033280;2015-10-13;CLI00084;FACTURA;28;1;277680;52759;330439
FAC0033281;2015-07-04;CLI00243;FACTURA;15;2;100735;19140;119875
FAC0033282;2015-03-03;CLI00384;FACTURA;36;1;243628;46289;289917
FAC0033283;2015-08-07;CLI00198;FACTURA;29;1;196245;37287;233532
FAC0033284;2015-04-22;CLI00103;FACTURA;40;2;201582;38301;239883
FAC0033285;2015-02-15;CLI00977;FACTURA;37;2;101715;19326;121041
FAC0033286;2015-03-07;CLI00121;FACTURA;33;2;214100;40679;254779
FAC0033287;2015-04-11;CLI00165;FACTURA;33;2;176360;33508;209868
FAC0033288;2015-08-11;CLI00789;FACTURA;34;2;135376;25721;161097
FAC0033289;2015-06-08;CLI00201;FACTURA;21;2;39012;7412;46424
FAC0033290;2015-04-27;CLI00690;FACTURA;18;1;47230;8974;56204
FAC0033291;2015-02-09;CLI00987;FACTURA;2;2;181323;34451;215774
FAC0033292;2015-07-15;CLI00544;FACTURA;36;1;91632;17410;109042
FAC0033293;2015-01-22;CLI00761;FACTURA;15;2;84388;16034;100422
FAC0033294;2015-04-13;CLI00227;FACTURA;14;2;67194;12767;79961
FAC0033295;2015-11-14;CLI00080;FACTURA;39;1;132279;25133;157412
FAC0033296;2015-09-10;CLI00221;FACTURA;37;2;133236;25315;158551
FAC0033297;2015-08-25;CLI00015;FACTURA;36;2;148008;28122;176130
FAC0033298;2015-08-16;CLI00917;FACTURA;1;2;31784;6039;37823
FAC0033299;2015-12-27;CLI00414;FACTURA;16;1;181112;34411;215523
FAC0033300;2015-11-29;CLI00297;FACTURA;32;2;67917;12904;80821
FAC0033301;2015-06-03;CLI00065;FACTURA;29;2;50742;9641;60383
FAC0033302;2015-03-11;CLI00141;FACTURA;39;2;61206;11629;72835
FAC0033303;2015-12-20;CLI00309;FACTURA;38;2;171048;32499;203547
FAC0033304;2015-11-22;CLI00448;FACTURA;23;1;132915;25254;158169
FAC0033305;2015-04-29;CLI00579;FACTURA;3;2;208824;39677;248501
FAC0033306;2015-07-23;CLI00413;FACTURA;21;2;101192;19226;120418
FAC0033307;2015-01-18;CLI00405;FACTURA;42;2;20958;3982;24940
FAC0033308;2015-09-23;CLI00084;FACTURA;22;1;10201;1938;12139
FAC0033309;2015-08-21;CLI00370;FACTURA;5;1;210970;40084;251054
FAC0033310;2015-05-30;CLI00292;FACTURA;16;1;144315;27420;171735
FAC0033311;2015-11-27;CLI00825;FACTURA;24;2;100791;19150;119941
FAC0033312;2015-05-21;CLI00953;FACTURA;19;2;202384;38453;240837
FAC0033313;2015-04-25;CLI00764;FACTURA;35;1;173550;32975;206525
FAC0033314;2015-02-14;CLI00061;FACTURA;18;2;163830;31128;194958
FAC0033315;2015-07-26;CLI00635;FACTURA;18;2;161360;30658;192018
FAC0033316;2015-10-11;CLI00453;FACTURA;3;2;54142;10287;64429
FAC0033317;2015-01-21;CLI00707;FACTURA;47;2;98452;18706;117158
FAC0033318;2015-07-22;CLI00848;FACTURA;10;1;243639;46291;289930
FAC0033319;2015-02-22;CLI00801;FACTURA;12;2;9483;1802;11285
FAC0033320;2015-02-01;CLI00472;FACTURA;48;1;177648;33753;211401
FAC0033321;2015-09-05;CLI00923;FACTURA;5;2;114032;21666;135698
FAC0033322;2015-09-13;CLI00771;FACTURA;19;2;9446;1795;11241
FAC0033323;2015-09-18;CLI00626;FACTURA;49;1;239309;45469;284778
FAC0033324;2015-10-07;CLI00225;FACTURA;18;2;177648;33753;211401
FAC0033325;2015-09-21;CLI00693;FACTURA;7;2;67584;12841;80425
FAC0033326;2015-03-13;CLI00269;FACTURA;20;2;17636;3351;20987
FAC0033327;2015-10-27;CLI00929;FACTURA;20;2;190701;36233;226934
FAC0033328;2015-02-26;CLI00515;FACTURA;32;2;102010;19382;121392
FAC0033329;2015-01-28;CLI00570;FACTURA;7;1;55622;10568;66190
FAC0033330;2015-10-13;CLI00777;FACTURA;36;2;94311;17919;112230
FAC0033331;2015-03-30;CLI00942;FACTURA;19;1;312390;59354;371744
FAC0033332;2015-12-26;CLI00189;FACTURA;9;2;75894;14420;90314
FAC0033333;2015-11-26;CLI00486;FACTURA;4;1;91809;17444;109253
FAC0033334;2015-02-07;CLI00333;FACTURA;29;2;81168;15422;96590
FAC0033335;2015-10-29;CLI00943;FACTURA;11;2;181112;34411;215523
FAC0033336;2015-07-02;CLI00871;FACTURA;23;2;160111;30421;190532
FAC0033337;2015-07-08;CLI00420;FACTURA;17;1;12340;2345;14685
FAC0033338;2015-09-14;CLI00108;FACTURA;49;1;159498;30305;189803
FAC0033339;2015-06-04;CLI00702;FACTURA;36;1;181323;34451;215774
FAC0033340;2015-03-01;CLI01000;FACTURA;30;1;195060;37061;232121
FAC0033341;2015-05-06;CLI00768;FACTURA;46;1;71670;13617;85287
FAC0033342;2015-10-08;CLI00712;FACTURA;40;1;56676;10768;67444
FAC0033343;2015-11-09;CLI00667;FACTURA;40;2;203784;38719;242503
FAC0033344;2015-06-19;CLI00685;FACTURA;43;2;139216;26451;165667
FAC0033345;2015-03-28;CLI00567;FACTURA;13;2;11454;2176;13630
FAC0033346;2015-05-26;CLI00410;FACTURA;42;1;16896;3210;20106
FAC0033347;2015-08-30;CLI00778;FACTURA;41;1;61700;11723;73423
FAC0033348;2015-09-03;CLI00265;FACTURA;47;2;12358;2348;14706
FAC0033349;2015-01-21;CLI00136;FACTURA;4;1;16914;3214;20128
FAC0033350;2015-09-22;CLI00881;FACTURA;38;2;75894;14420;90314
FAC0033351;2015-09-29;CLI00612;FACTURA;17;1;11917;2264;14181
FAC0033352;2015-12-19;CLI00983;FACTURA;37;2;216568;41148;257716
FAC0033353;2015-02-23;CLI00713;FACTURA;46;2;140555;26705;167260
FAC0033354;2015-12-23;CLI00654;FACTURA;23;1;208260;39569;247829
FAC0033355;2015-11-14;CLI00926;FACTURA;5;1;32272;6132;38404
FAC0033356;2015-01-20;CLI00472;FACTURA;17;1;18537;3522;22059
FAC0033357;2015-04-11;CLI00582;FACTURA;11;1;59585;11321;70906
FAC0033358;2015-01-29;CLI00512;FACTURA;25;1;49336;9374;58710
FAC0033359;2015-06-28;CLI00292;FACTURA;2;1;175554;33355;208909
FAC0033360;2015-07-03;CLI00414;FACTURA;15;1;202384;38453;240837
FAC0033361;2015-07-30;CLI00668;FACTURA;5;1;218050;41430;259480
FAC0033362;2015-03-29;CLI00095;FACTURA;43;2;168666;32047;200713
FAC0033363;2015-01-03;CLI00683;FACTURA;31;2;182984;34767;217751
FAC0033364;2015-07-16;CLI00403;FACTURA;21;2;71514;13588;85102
FAC0033365;2015-11-03;CLI00282;FACTURA;19;1;174020;33064;207084
FAC0033366;2015-03-08;CLI00908;FACTURA;44;1;14334;2723;17057
FAC0033367;2015-03-17;CLI00956;FACTURA;12;1;43002;8170;51172
FAC0033368;2015-01-08;CLI00092;FACTURA;50;1;11454;2176;13630
FAC0033369;2015-07-22;CLI00178;FACTURA;16;1;11454;2176;13630
FAC0033370;2015-04-14;CLI00777;FACTURA;4;2;104790;19910;124700
FAC0033371;2015-12-01;CLI00223;FACTURA;13;2;39730;7549;47279
FAC0033372;2015-07-07;CLI00539;FACTURA;1;2;52395;9955;62350
FAC0033373;2015-05-08;CLI00601;FACTURA;40;2;47230;8974;56204
FAC0033374;2015-05-14;CLI00182;FACTURA;6;1;131064;24902;155966
FAC0033375;2015-12-21;CLI00460;FACTURA;6;1;152298;28937;181235
FAC0033376;2015-06-09;CLI00664;FACTURA;14;1;84480;16051;100531
FAC0033377;2015-05-31;CLI00344;FACTURA;8;1;48105;9140;57245
FAC0033378;2015-05-23;CLI00848;FACTURA;12;1;68370;12990;81360
FAC0033379;2015-06-03;CLI00229;FACTURA;44;2;114540;21763;136303
FAC0033380;2015-01-13;CLI00060;FACTURA;49;1;56898;10811;67709
FAC0033381;2015-04-12;CLI00665;FACTURA;19;2;199854;37972;237826
FAC0033382;2015-04-07;CLI00631;FACTURA;34;2;30850;5862;36712
FAC0033383;2015-08-16;CLI00434;FACTURA;28;1;22639;4301;26940
FAC0033384;2015-01-02;CLI00471;FACTURA;16;2;128280;24373;152653
FAC0033385;2015-08-22;CLI00050;FACTURA;30;1;265830;50508;316338
FAC0033386;2015-07-14;CLI00694;FACTURA;33;1;175554;33355;208909
FAC0033387;2015-07-26;CLI00680;FACTURA;49;1;22908;4353;27261
FAC0033388;2015-05-18;CLI00592;FACTURA;27;1;174018;33063;207081
FAC0033389;2015-12-17;CLI00093;FACTURA;21;2;160111;30421;190532
FAC0033390;2015-12-26;CLI00238;FACTURA;8;1;75588;14362;89950
FAC0033391;2015-08-24;CLI00387;FACTURA;35;2;5638;1071;6709
FAC0033392;2015-06-07;CLI00548;FACTURA;38;1;229362;43579;272941
FAC0033393;2015-05-12;CLI00249;FACTURA;35;2;172291;32735;205026
FAC0033394;2015-08-30;CLI00613;FACTURA;36;2;80178;15234;95412
FAC0033395;2015-05-28;CLI00931;FACTURA;18;2;228064;43332;271396
FAC0033396;2015-05-08;CLI00447;FACTURA;11;2;40584;7711;48295
FAC0033397;2015-03-13;CLI00185;FACTURA;7;2;56898;10811;67709
FAC0033398;2015-05-07;CLI00911;FACTURA;33;2;30603;5815;36418
FAC0033399;2015-12-12;CLI00003;FACTURA;9;2;80178;15234;95412
FAC0033400;2015-05-09;CLI00076;FACTURA;20;1;205122;38973;244095
FAC0033401;2015-06-25;CLI00089;FACTURA;20;2;211170;40122;251292
FAC0033402;2015-12-27;CLI00290;FACTURA;4;1;170073;32314;202387
FAC0033403;2015-07-04;CLI00005;FACTURA;12;2;81372;15461;96833
FAC0033404;2015-12-20;CLI00119;FACTURA;26;2;28668;5447;34115
FAC0033405;2015-08-26;CLI00458;FACTURA;24;1;44412;8438;52850
FAC0033406;2015-01-09;CLI00964;FACTURA;9;1;40686;7730;48416
FAC0033407;2015-06-18;CLI00244;FACTURA;27;1;196245;37287;233532
FAC0033408;2015-01-17;CLI00575;FACTURA;12;2;249381;47382;296763
FAC0033409;2015-11-30;CLI00905;FACTURA;10;2;160111;30421;190532
FAC0033410;2015-08-05;CLI00879;FACTURA;45;2;16922;3215;20137
FAC0033411;2015-07-09;CLI00155;FACTURA;18;2;84480;16051;100531
FAC0033412;2015-08-14;CLI00088;FACTURA;14;1;142401;27056;169457
FAC0033413;2015-03-18;CLI00310;FACTURA;18;1;123340;23435;146775
FAC0033414;2015-01-24;CLI00202;FACTURA;35;1;67194;12767;79961
FAC0033415;2015-04-02;CLI00220;FACTURA;29;1;9446;1795;11241
FAC0033416;2015-12-03;CLI00272;FACTURA;44;1;16035;3047;19082
FAC0033417;2015-11-25;CLI00915;FACTURA;31;2;243628;46289;289917
FAC0033418;2015-02-22;CLI00132;FACTURA;48;1;145015;27553;172568
FAC0033419;2015-08-12;CLI00776;FACTURA;43;1;31437;5973;37410
FAC0033420;2015-06-10;CLI00552;FACTURA;3;1;162744;30921;193665
FAC0033421;2015-03-13;CLI00653;FACTURA;28;2;153013;29072;182085
FAC0033422;2015-08-11;CLI00982;FACTURA;2;1;169220;32152;201372
FAC0033423;2015-11-14;CLI00691;FACTURA;12;2;181323;34451;215774
FAC0033424;2015-05-30;CLI00597;FACTURA;40;2;68724;13058;81782
FAC0033425;2015-05-01;CLI00971;FACTURA;48;2;84388;16034;100422
FAC0033426;2015-08-06;CLI00763;FACTURA;13;2;73839;14029;87868
FAC0033427;2015-04-19;CLI00227;FACTURA;29;2;106332;20203;126535
FAC0033428;2015-05-30;CLI00174;FACTURA;22;1;31437;5973;37410
FAC0033429;2015-03-29;CLI00289;FACTURA;48;2;20343;3865;24208
FAC0033430;2015-03-08;CLI00100;FACTURA;45;1;54142;10287;64429
FAC0033431;2015-08-21;CLI00491;FACTURA;21;2;71670;13617;85287
FAC0033432;2015-11-07;CLI00785;FACTURA;2;2;216568;41148;257716
FAC0033433;2015-05-06;CLI00090;FACTURA;46;1;100338;19064;119402
FAC0033434;2015-01-09;CLI00509;FACTURA;32;2;265830;50508;316338
FAC0033435;2015-06-22;CLI00051;FACTURA;17;2;51005;9691;60696
FAC0033436;2015-04-05;CLI00009;FACTURA;5;2;156048;29649;185697
FAC0033437;2015-12-27;CLI00057;FACTURA;24;2;196245;37287;233532
FAC0033438;2015-11-08;CLI00505;FACTURA;30;2;67194;12767;79961
FAC0033439;2015-12-22;CLI00639;FACTURA;15;2;135834;25808;161642
FAC0033440;2015-03-06;CLI00044;FACTURA;7;1;33792;6420;40212
FAC0033441;2015-07-20;CLI00027;FACTURA;28;2;28449;5405;33854
FAC0033442;2015-06-09;CLI00583;FACTURA;22;2;268776;51067;319843
FAC0033443;2015-11-02;CLI00328;FACTURA;15;1;307683;58460;366143
FAC0033444;2015-11-28;CLI00158;FACTURA;17;1;117036;22237;139273
FAC0033445;2015-07-11;CLI00014;FACTURA;8;1;27348;5196;32544
FAC0033446;2015-01-31;CLI00527;FACTURA;20;2;239309;45469;284778
FAC0033447;2015-12-02;CLI00017;FACTURA;10;2;55530;10551;66081
FAC0033448;2015-02-10;CLI00627;FACTURA;2;2;67917;12904;80821
FAC0033449;2015-06-04;CLI00138;FACTURA;14;1;217944;41409;259353
FAC0033450;2015-06-23;CLI00856;FACTURA;6;1;177086;33646;210732
FAC0033451;2015-10-16;CLI00896;FACTURA;26;1;162744;30921;193665
FAC0033452;2015-04-05;CLI00261;FACTURA;32;2;21859;4153;26012
FAC0033453;2015-07-13;CLI00250;FACTURA;38;1;228730;43459;272189
FAC0033454;2015-06-20;CLI00263;FACTURA;29;2;25473;4840;30313
FAC0033455;2015-02-10;CLI00780;FACTURA;6;1;135834;25808;161642
FAC0033456;2015-06-16;CLI00928;FACTURA;43;1;122058;23191;145249
FAC0033457;2015-04-04;CLI00041;FACTURA;50;2;31784;6039;37823
FAC0033458;2015-01-10;CLI00612;FACTURA;20;1;61206;11629;72835
FAC0033459;2015-01-30;CLI00251;FACTURA;6;2;201470;38279;239749
FAC0033460;2015-07-02;CLI00188;FACTURA;34;1;272430;51762;324192
FAC0033461;2015-03-03;CLI00975;FACTURA;15;2;71670;13617;85287
FAC0033462;2015-04-30;CLI00663;FACTURA;17;2;81608;15506;97114
FAC0033463;2015-09-07;CLI00317;FACTURA;33;2;25473;4840;30313
FAC0033464;2015-09-22;CLI00988;FACTURA;11;1;278432;52902;331334
FAC0033465;2015-03-01;CLI00996;FACTURA;40;1;109025;20715;129740
FAC0033466;2015-07-05;CLI00139;FACTURA;1;2;56380;10712;67092
FAC0033467;2015-11-30;CLI00742;FACTURA;46;1;129006;24511;153517
FAC0033468;2015-07-06;CLI00871;FACTURA;15;2;59136;11236;70372
FAC0033469;2015-07-28;CLI00326;FACTURA;24;1;52395;9955;62350
FAC0033470;2015-11-24;CLI00394;FACTURA;47;1;18892;3589;22481
FAC0033471;2015-04-05;CLI00886;FACTURA;46;1;63351;12037;75388
FAC0033472;2015-09-20;CLI00818;FACTURA;39;1;131154;24919;156073
FAC0033473;2015-02-23;CLI00710;FACTURA;48;1;105485;20042;125527
FAC0033474;2015-10-28;CLI00803;FACTURA;8;2;278432;52902;331334
FAC0033475;2015-05-21;CLI00716;FACTURA;23;1;162744;30921;193665
FAC0033476;2015-12-10;CLI00156;FACTURA;22;1;96816;18395;115211
FAC0033477;2015-01-31;CLI00396;FACTURA;41;1;76419;14520;90939
FAC0033478;2015-09-11;CLI00363;FACTURA;16;2;37020;7034;44054
FAC0033479;2015-04-18;CLI00821;FACTURA;43;2;21410;4068;25478
FAC0033480;2015-06-29;CLI00575;FACTURA;17;2;43718;8306;52024
FAC0033481;2015-02-26;CLI00318;FACTURA;15;1;163458;31057;194515
FAC0033482;2015-11-11;CLI00815;FACTURA;28;2;107050;20340;127390
FAC0033483;2015-09-06;CLI00815;FACTURA;6;2;168666;32047;200713
FAC0033484;2015-11-19;CLI00345;FACTURA;4;2;65532;12451;77983
FAC0033485;2015-06-07;CLI00584;FACTURA;28;1;114032;21666;135698
FAC0033486;2015-06-07;CLI00699;FACTURA;11;2;37794;7181;44975
FAC0033487;2015-11-19;CLI00869;FACTURA;17;2;327660;62255;389915
FAC0033488;2015-08-20;CLI00205;FACTURA;17;2;139216;26451;165667
FAC0033489;2015-07-28;CLI00548;FACTURA;49;1;54142;10287;64429
FAC0033490;2015-01-31;CLI00678;FACTURA;41;1;196731;37379;234110
FAC0033491;2015-09-09;CLI00471;FACTURA;26;2;44412;8438;52850
FAC0033492;2015-05-22;CLI00028;FACTURA;49;1;243628;46289;289917
FAC0033493;2015-07-14;CLI00761;FACTURA;14;2;10201;1938;12139
FAC0033494;2015-10-28;CLI00605;FACTURA;6;2;129088;24527;153615
FAC0033495;2015-06-06;CLI00076;FACTURA;7;1;66618;12657;79275
FAC0033496;2015-03-23;CLI00667;FACTURA;50;2;109025;20715;129740
FAC0033497;2015-02-15;CLI00109;FACTURA;6;2;71670;13617;85287
FAC0033498;2015-02-17;CLI00921;FACTURA;44;2;201582;38301;239883
FAC0033499;2015-08-18;CLI00228;FACTURA;37;1;55622;10568;66190
FAC0033500;2015-01-16;CLI00052;FACTURA;12;1;128280;24373;152653
FAC0033501;2015-12-10;CLI00517;FACTURA;37;2;22908;4353;27261
FAC0033502;2015-05-17;CLI00339;FACTURA;38;2;33844;6430;40274
FAC0033503;2015-10-06;CLI00641;FACTURA;37;2;285080;54165;339245
FAC0033504;2015-11-12;CLI00422;FACTURA;1;1;11276;2142;13418
FAC0033505;2015-10-20;CLI00135;FACTURA;28;2;177086;33646;210732
FAC0033506;2015-12-01;CLI00059;FACTURA;18;2;201582;38301;239883
FAC0033507;2015-01-13;CLI00251;FACTURA;36;2;210970;40084;251054
FAC0033508;2015-09-22;CLI00070;FACTURA;16;1;133236;25315;158551
FAC0033509;2015-05-25;CLI00659;FACTURA;44;2;65532;12451;77983
FAC0033510;2015-06-10;CLI00566;FACTURA;1;1;168666;32047;200713
FAC0033511;2015-05-25;CLI00524;FACTURA;6;1;61029;11596;72625
FAC0033512;2015-06-23;CLI00138;FACTURA;34;1;109295;20766;130061
FAC0033513;2015-11-11;CLI00443;FACTURA;28;2;16035;3047;19082
FAC0033514;2015-05-14;CLI00002;FACTURA;18;1;43253;8218;51471
FAC0033515;2015-10-12;CLI00692;FACTURA;10;1;135355;25717;161072
FAC0033516;2015-12-12;CLI00284;FACTURA;4;1;197344;37495;234839
FAC0033517;2015-02-28;CLI00491;FACTURA;26;2;58518;11118;69636
FAC0033518;2015-10-06;CLI00091;FACTURA;44;2;112444;21364;133808
FAC0033519;2015-04-21;CLI00947;FACTURA;41;2;82044;15588;97632
FAC0033520;2015-10-03;CLI00363;FACTURA;48;2;168776;32067;200843
FAC0033521;2015-01-14;CLI00196;FACTURA;14;1;285080;54165;339245
FAC0033522;2015-09-03;CLI00416;FACTURA;34;1;190701;36233;226934
FAC0033523;2015-09-16;CLI00637;FACTURA;45;2;28111;5341;33452
FAC0033524;2015-08-13;CLI00033;FACTURA;24;2;192690;36611;229301
FAC0033525;2015-06-09;CLI00388;FACTURA;8;1;20402;3876;24278
FAC0033526;2015-02-03;CLI00255;FACTURA;48;2;69420;13190;82610
FAC0033527;2015-07-23;CLI00317;FACTURA;14;2;50742;9641;60383
FAC0033528;2015-03-17;CLI00661;FACTURA;9;2;64230;12204;76434
FAC0033529;2015-04-16;CLI00159;FACTURA;46;2;193963;36853;230816
FAC0033530;2015-10-01;CLI00922;FACTURA;33;1;113195;21507;134702
FAC0033531;2015-08-20;CLI00382;FACTURA;24;1;28190;5356;33546
FAC0033532;2015-04-30;CLI00583;FACTURA;21;2;81372;15461;96833
FAC0033533;2015-10-24;CLI00434;FACTURA;23;1;118454;22506;140960
FAC0033534;2015-02-24;CLI00869;FACTURA;5;2;11454;2176;13630
FAC0033535;2015-12-04;CLI00930;FACTURA;40;1;71022;13494;84516
FAC0033536;2015-10-04;CLI00039;FACTURA;43;2;249381;47382;296763
FAC0033537;2015-04-08;CLI00354;FACTURA;50;1;20147;3828;23975
FAC0033538;2015-10-25;CLI00317;FACTURA;47;2;174020;33064;207084
FAC0033539;2015-06-17;CLI00248;FACTURA;28;1;13674;2598;16272
FAC0033540;2015-12-18;CLI00749;FACTURA;38;2;50946;9680;60626
FAC0033541;2015-08-05;CLI00276;FACTURA;23;1;84333;16023;100356
FAC0033542;2015-07-11;CLI00652;FACTURA;31;1;39730;7549;47279
FAC0033543;2015-02-10;CLI00580;FACTURA;5;1;88824;16877;105701
FAC0033544;2015-12-03;CLI00410;FACTURA;16;1;23834;4528;28362
FAC0033545;2015-07-17;CLI00399;FACTURA;24;2;166254;31588;197842
FAC0033546;2015-09-08;CLI00950;FACTURA;48;1;50688;9631;60319
FAC0033547;2015-08-16;CLI00897;FACTURA;26;2;24716;4696;29412
FAC0033548;2015-12-06;CLI00779;FACTURA;37;2;203021;38574;241595
FAC0033549;2015-11-19;CLI00287;FACTURA;40;2;84468;16049;100517
FAC0033550;2015-03-20;CLI00487;FACTURA;43;2;105816;20105;125921
FAC0033551;2015-02-19;CLI00745;FACTURA;20;2;270710;51435;322145
FAC0033552;2015-02-23;CLI00696;FACTURA;33;1;173550;32975;206525
FAC0033553;2015-03-02;CLI00741;FACTURA;43;2;20147;3828;23975
FAC0033554;2015-09-24;CLI00017;FACTURA;41;2;84468;16049;100517
FAC0033555;2015-03-15;CLI00712;FACTURA;16;1;76032;14446;90478
FAC0033556;2015-02-04;CLI00057;FACTURA;8;2;87009;16532;103541
FAC0033557;2015-06-07;CLI00988;FACTURA;24;1;232024;44085;276109
FAC0033558;2015-05-16;CLI00139;FACTURA;33;2;224888;42729;267617
FAC0033559;2015-06-22;CLI00267;FACTURA;25;2;107050;20340;127390
FAC0033560;2015-05-13;CLI00472;FACTURA;33;1;56691;10771;67462
FAC0033561;2015-08-06;CLI00459;FACTURA;29;2;70544;13403;83947
FAC0033562;2015-10-21;CLI00856;FACTURA;33;1;178311;33879;212190
FAC0033563;2015-11-05;CLI00833;FACTURA;47;2;33844;6430;40274
FAC0033564;2015-06-10;CLI00016;FACTURA;7;1;160350;30467;190817
FAC0033565;2015-06-02;CLI00815;FACTURA;28;2;56380;10712;67092
FAC0033566;2015-07-05;CLI00209;FACTURA;1;2;22873;4346;27219
FAC0033567;2015-09-01;CLI00172;FACTURA;19;1;71514;13588;85102
FAC0033568;2015-07-06;CLI00313;FACTURA;4;2;48408;9198;57606
FAC0033569;2015-01-11;CLI00430;FACTURA;35;1;58006;11021;69027
FAC0033570;2015-03-26;CLI00289;FACTURA;5;2;163830;31128;194958
FAC0033571;2015-02-14;CLI00099;FACTURA;34;2;273496;51964;325460
FAC0033572;2015-09-09;CLI00660;FACTURA;2;1;135376;25721;161097
FAC0033573;2015-08-22;CLI00248;FACTURA;3;1;177648;33753;211401
FAC0033574;2015-08-10;CLI00120;FACTURA;19;1;91314;17350;108664
FAC0033575;2015-05-12;CLI00049;FACTURA;14;2;27243;5176;32419
FAC0033576;2015-11-20;CLI00522;FACTURA;50;1;214100;40679;254779
FAC0033577;2015-07-28;CLI00756;FACTURA;42;1;205857;39113;244970
FAC0033578;2015-12-29;CLI00819;FACTURA;14;2;85524;16250;101774
FAC0033579;2015-03-15;CLI00771;FACTURA;8;2;112444;21364;133808
FAC0033580;2015-10-15;CLI00939;FACTURA;10;2;62874;11946;74820
FAC0033581;2015-05-15;CLI00288;FACTURA;43;1;168936;32098;201034
FAC0033582;2015-04-28;CLI00395;FACTURA;39;2;45104;8570;53674
FAC0033583;2015-07-03;CLI00064;FACTURA;33;1;138545;26324;164869
FAC0033584;2015-05-02;CLI00865;FACTURA;45;2;45278;8603;53881
FAC0033585;2015-01-06;CLI00051;FACTURA;31;2;153013;29072;182085
FAC0033586;2015-10-15;CLI00978;FACTURA;8;1;224888;42729;267617
FAC0033587;2015-01-31;CLI00718;FACTURA;50;1;83127;15794;98921
FAC0033588;2015-03-17;CLI00476;FACTURA;5;1;24668;4687;29355
FAC0033589;2015-05-01;CLI00051;FACTURA;17;2;43253;8218;51471
FAC0033590;2015-06-06;CLI00330;FACTURA;23;1;281110;53411;334521
FAC0033591;2015-04-13;CLI00895;FACTURA;31;2;216568;41148;257716
FAC0033592;2015-10-22;CLI00915;FACTURA;34;2;45816;8705;54521
FAC0033593;2015-05-03;CLI00193;FACTURA;22;2;254060;48271;302331
FAC0033594;2015-11-21;CLI00858;FACTURA;16;1;67194;12767;79961
FAC0033595;2015-09-04;CLI00224;FACTURA;1;1;270710;51435;322145
FAC0033596;2015-09-29;CLI00444;FACTURA;2;1;85347;16216;101563
FAC0033597;2015-09-10;CLI00864;FACTURA;21;1;18966;3604;22570
FAC0033598;2015-08-04;CLI00763;FACTURA;19;2;205122;38973;244095
FAC0033599;2015-06-04;CLI00495;FACTURA;15;2;75568;14358;89926
FAC0033600;2015-03-08;CLI00872;FACTURA;41;1;126490;24033;150523
FAC0033601;2015-02-23;CLI00449;FACTURA;18;2;6179;1174;7353
FAC0033602;2015-09-05;CLI00278;FACTURA;9;1;108284;20574;128858
FAC0033603;2015-08-25;CLI00479;FACTURA;10;2;60876;11566;72442
FAC0033604;2015-09-09;CLI00822;FACTURA;36;1;281110;53411;334521
FAC0033605;2015-03-30;CLI00563;FACTURA;31;2;40584;7711;48295
FAC0033606;2015-09-16;CLI00139;FACTURA;27;2;91809;17444;109253
FAC0033607;2015-03-23;CLI00463;FACTURA;43;2;94830;18018;112848
FAC0033608;2015-07-20;CLI00082;FACTURA;6;1;80178;15234;95412
FAC0033609;2015-04-26;CLI00297;FACTURA;8;2;252980;48066;301046
FAC0033610;2015-11-27;CLI00350;FACTURA;6;1;227682;43260;270942
FAC0033611;2015-08-12;CLI00738;FACTURA;24;1;152838;29039;181877
FAC0033612;2015-10-21;CLI00063;FACTURA;18;2;224888;42729;267617
FAC0033613;2015-11-24;CLI00638;FACTURA;49;1;67917;12904;80821
FAC0033614;2015-11-10;CLI00924;FACTURA;50;1;12358;2348;14706
FAC0033615;2015-03-19;CLI00104;FACTURA;50;1;71502;13585;85087
FAC0033616;2015-10-19;CLI00963;FACTURA;18;2;42234;8024;50258
FAC0033617;2015-03-11;CLI00364;FACTURA;37;1;55611;10566;66177
FAC0033618;2015-03-02;CLI00942;FACTURA;15;1;123452;23456;146908
FAC0033619;2015-01-17;CLI00922;FACTURA;48;1;136215;25881;162096
FAC0033620;2015-02-18;CLI00096;FACTURA;4;1;162744;30921;193665
FAC0033621;2015-04-30;CLI00243;FACTURA;7;2;53166;10102;63268
FAC0033622;2015-01-10;CLI00288;FACTURA;9;1;18897;3590;22487
FAC0033623;2015-10-31;CLI00377;FACTURA;33;2;40804;7753;48557
FAC0033624;2015-02-04;CLI00414;FACTURA;29;1;61790;11740;73530
FAC0033625;2015-09-27;CLI00410;FACTURA;17;1;10479;1991;12470
FAC0033626;2015-06-01;CLI00504;FACTURA;33;1;52395;9955;62350
FAC0033627;2015-11-23;CLI00543;FACTURA;9;2;60876;11566;72442
FAC0033628;2015-08-06;CLI00325;FACTURA;11;2;242970;46164;289134
FAC0033629;2015-08-01;CLI00325;FACTURA;16;2;177648;33753;211401
FAC0033630;2015-11-13;CLI00138;FACTURA;3;1;96816;18395;115211
FAC0033631;2015-05-26;CLI00918;FACTURA;21;1;28508;5417;33925
FAC0033632;2015-06-14;CLI00197;FACTURA;24;2;21117;4012;25129
FAC0033633;2015-09-27;CLI00284;FACTURA;47;1;6179;1174;7353
FAC0033634;2015-12-18;CLI00596;FACTURA;10;1;47668;9057;56725
FAC0033635;2015-03-14;CLI00145;FACTURA;20;2;221672;42118;263790
FAC0033636;2015-04-18;CLI00799;FACTURA;33;2;94460;17947;112407
FAC0033637;2015-08-11;CLI00237;FACTURA;12;2;53166;10102;63268
FAC0033638;2015-08-28;CLI00364;FACTURA;31;1;30438;5783;36221
FAC0033639;2015-04-28;CLI00270;FACTURA;30;1;86004;16341;102345
FAC0033640;2015-03-23;CLI00785;FACTURA;27;2;120882;22968;143850
FAC0033641;2015-05-08;CLI00937;FACTURA;37;2;138545;26324;164869
FAC0033642;2015-10-19;CLI00201;FACTURA;11;2;69608;13226;82834
FAC0033643;2015-03-26;CLI00132;FACTURA;36;1;81729;15529;97258
FAC0033644;2015-11-29;CLI00922;FACTURA;23;1;132915;25254;158169
FAC0033645;2015-08-12;CLI00047;FACTURA;25;2;48408;9198;57606
FAC0033646;2015-10-09;CLI00269;FACTURA;26;2;208824;39677;248501
FAC0033647;2015-12-01;CLI00925;FACTURA;36;2;41022;7794;48816
FAC0033648;2015-04-26;CLI00322;FACTURA;39;1;118454;22506;140960
FAC0033649;2015-08-11;CLI00328;FACTURA;9;1;24716;4696;29412
FAC0033650;2015-02-15;CLI00932;FACTURA;23;1;9483;1802;11285
FAC0033651;2015-08-10;CLI00657;FACTURA;7;2;22908;4353;27261
FAC0033652;2015-01-18;CLI00374;FACTURA;42;1;123452;23456;146908
FAC0033653;2015-03-16;CLI00766;FACTURA;28;1;60876;11566;72442
FAC0033654;2015-01-11;CLI00345;FACTURA;14;2;37794;7181;44975
FAC0033655;2015-06-25;CLI00521;FACTURA;40;2;128460;24407;152867
FAC0033656;2015-04-25;CLI00087;FACTURA;41;2;181323;34451;215774
FAC0033657;2015-05-08;CLI00323;FACTURA;49;2;126490;24033;150523
FAC0033658;2015-02-03;CLI00271;FACTURA;34;2;161176;30623;191799
FAC0033659;2015-05-04;CLI00214;FACTURA;50;1;28190;5356;33546
FAC0033660;2015-10-13;CLI00221;FACTURA;47;2;22639;4301;26940
FAC0033661;2015-09-06;CLI00467;FACTURA;27;2;285080;54165;339245
FAC0033662;2015-08-04;CLI00849;FACTURA;14;2;190053;36110;226163
FAC0033663;2015-03-26;CLI00882;FACTURA;34;1;335970;63834;399804
FAC0033664;2015-02-26;CLI00869;FACTURA;48;2;32070;6093;38163
FAC0033665;2015-04-15;CLI00541;FACTURA;39;2;196245;37287;233532
FAC0033666;2015-04-27;CLI00746;FACTURA;29;1;18510;3517;22027
FAC0033667;2015-05-26;CLI00805;FACTURA;36;2;159498;30305;189803
FAC0033668;2015-05-29;CLI00928;FACTURA;5;1;65415;12429;77844
FAC0033669;2015-04-21;CLI00269;FACTURA;44;2;49336;9374;58710
FAC0033670;2015-07-05;CLI00678;FACTURA;30;1;347100;65949;413049
FAC0033671;2015-10-30;CLI00573;FACTURA;13;2;127365;24199;151564
FAC0033672;2015-04-07;CLI00694;FACTURA;19;1;158724;30158;188882
FAC0033673;2015-03-30;CLI00569;FACTURA;3;2;216568;41148;257716
FAC0033674;2015-06-12;CLI00404;FACTURA;24;1;81213;15430;96643
FAC0033675;2015-05-14;CLI00205;FACTURA;2;2;166254;31588;197842
FAC0033676;2015-11-29;CLI00233;FACTURA;18;2;188970;35904;224874
FAC0033677;2015-11-21;CLI00404;FACTURA;42;1;83127;15794;98921
FAC0033678;2015-10-04;CLI00244;FACTURA;3;1;27071;5143;32214
FAC0033679;2015-09-28;CLI00406;FACTURA;44;1;108972;20705;129677
FAC0033680;2015-05-03;CLI00392;FACTURA;43;1;277090;52647;329737
FAC0033681;2015-06-15;CLI00985;FACTURA;44;2;58006;11021;69027
FAC0033682;2015-04-27;CLI00695;FACTURA;2;2;63351;12037;75388
FAC0033683;2015-01-23;CLI00298;FACTURA;37;1;135355;25717;161072
FAC0033684;2015-11-30;CLI00786;FACTURA;11;1;112444;21364;133808
FAC0033685;2015-06-22;CLI00420;FACTURA;26;1;52908;10053;62961
FAC0033686;2015-06-16;CLI00282;FACTURA;3;1;203021;38574;241595
FAC0033687;2015-07-05;CLI00326;FACTURA;11;1;56676;10768;67444
FAC0033688;2015-07-09;CLI00375;FACTURA;3;2;81372;15461;96833
FAC0033689;2015-06-29;CLI00983;FACTURA;36;2;15892;3019;18911
FAC0033690;2015-02-03;CLI00948;FACTURA;3;1;63568;12078;75646
FAC0033691;2015-01-21;CLI00701;FACTURA;41;2;341870;64955;406825
FAC0033692;2015-09-02;CLI00250;FACTURA;34;1;55611;10566;66177
FAC0033693;2015-04-26;CLI00100;FACTURA;31;1;31437;5973;37410
FAC0033694;2015-07-31;CLI00119;FACTURA;14;2;64544;12263;76807
FAC0033695;2015-12-16;CLI00708;FACTURA;32;1;163458;31057;194515
FAC0033696;2015-08-03;CLI00406;FACTURA;47;1;181112;34411;215523
FAC0033697;2015-12-25;CLI00196;FACTURA;45;1;228730;43459;272189
FAC0033698;2015-02-23;CLI00525;FACTURA;47;2;50766;9646;60412
FAC0033699;2015-05-03;CLI00302;FACTURA;10;1;52395;9955;62350
FAC0033700;2015-03-17;CLI00750;FACTURA;24;1;229362;43579;272941
FAC0033701;2015-05-16;CLI00908;FACTURA;24;1;312390;59354;371744
FAC0033702;2015-01-05;CLI00941;FACTURA;47;2;136748;25982;162730
FAC0033703;2015-12-05;CLI00179;FACTURA;19;2;41916;7964;49880
FAC0033704;2015-05-01;CLI00807;FACTURA;15;2;81168;15422;96590
FAC0033705;2015-07-26;CLI00468;FACTURA;17;1;104412;19838;124250
FAC0033706;2015-10-08;CLI00988;FACTURA;29;1;18897;3590;22487
FAC0033707;2015-05-23;CLI00075;FACTURA;20;2;170935;32478;203413
FAC0033708;2015-08-16;CLI00489;FACTURA;28;2;135834;25808;161642
FAC0033709;2015-04-07;CLI00417;FACTURA;49;2;76419;14520;90939
FAC0033710;2015-07-16;CLI00680;FACTURA;12;1;53166;10102;63268
FAC0033711;2015-06-19;CLI00586;FACTURA;23;1;56380;10712;67092
FAC0033712;2015-08-06;CLI00412;FACTURA;24;1;28111;5341;33452
FAC0033713;2015-07-31;CLI00695;FACTURA;43;2;63568;12078;75646
FAC0033714;2015-08-06;CLI00068;FACTURA;48;1;91632;17410;109042
FAC0033715;2015-08-14;CLI00553;FACTURA;32;2;168936;32098;201034
FAC0033716;2015-04-16;CLI00641;FACTURA;16;2;42820;8136;50956
FAC0033717;2015-02-26;CLI00700;FACTURA;5;1;172291;32735;205026
FAC0033718;2015-04-16;CLI00887;FACTURA;28;2;49360;9378;58738
FAC0033719;2015-06-07;CLI00181;FACTURA;45;2;35751;6793;42544
FAC0033720;2015-03-27;CLI00230;FACTURA;36;1;86004;16341;102345
FAC0033721;2015-11-14;CLI00862;FACTURA;43;1;101715;19326;121041
FAC0033722;2015-06-02;CLI00818;FACTURA;24;1;98298;18677;116975
FAC0033723;2015-01-31;CLI00172;FACTURA;28;1;68374;12991;81365
FAC0033724;2015-12-11;CLI00828;FACTURA;44;1;239247;45457;284704
FAC0033725;2015-12-13;CLI00417;FACTURA;3;2;173550;32975;206525
FAC0033726;2015-11-28;CLI00967;FACTURA;39;2;85640;16272;101912
FAC0033727;2015-08-23;CLI00802;FACTURA;43;1;69420;13190;82610
FAC0033728;2015-03-20;CLI00758;FACTURA;17;1;307683;58460;366143
FAC0033729;2015-08-11;CLI00429;FACTURA;21;2;281110;53411;334521
FAC0033730;2015-11-05;CLI00549;FACTURA;44;2;197344;37495;234839
FAC0033731;2015-02-14;CLI00592;FACTURA;3;1;102561;19487;122048
FAC0033732;2015-11-16;CLI00971;FACTURA;25;2;56380;10712;67092
FAC0033733;2015-12-07;CLI00875;FACTURA;7;2;48408;9198;57606
FAC0033734;2015-04-15;CLI00397;FACTURA;10;2;85347;16216;101563
FAC0033735;2015-05-14;CLI00933;FACTURA;41;2;109392;20784;130176
FAC0033736;2015-04-28;CLI00762;FACTURA;36;1;54486;10352;64838
FAC0033737;2015-12-11;CLI00481;FACTURA;22;2;23838;4529;28367
FAC0033738;2015-10-23;CLI00001;FACTURA;50;2;91632;17410;109042
FAC0033739;2015-10-17;CLI00978;FACTURA;36;1;192690;36611;229301
FAC0033740;2015-12-01;CLI00827;FACTURA;11;2;34362;6529;40891
FAC0033741;2015-03-14;CLI00503;FACTURA;43;2;54696;10392;65088
FAC0033742;2015-07-25;CLI00854;FACTURA;35;1;174018;33063;207081
FAC0033743;2015-01-12;CLI00874;FACTURA;6;1;227682;43260;270942
FAC0033744;2015-06-11;CLI00561;FACTURA;21;2;12358;2348;14706
FAC0033745;2015-01-13;CLI00491;FACTURA;32;2;55418;10529;65947
FAC0033746;2015-06-21;CLI00348;FACTURA;11;1;25406;4827;30233
FAC0033747;2015-09-06;CLI00453;FACTURA;42;2;6179;1174;7353
FAC0033748;2015-10-30;CLI00159;FACTURA;18;2;16922;3215;20137
FAC0033749;2015-08-23;CLI00469;FACTURA;8;2;101715;19326;121041
FAC0033750;2015-05-05;CLI00721;FACTURA;4;2;249381;47382;296763
FAC0033751;2015-03-31;CLI00186;FACTURA;39;1;49226;9353;58579
FAC0033752;2015-09-02;CLI00214;FACTURA;17;1;57270;10881;68151
FAC0033753;2015-11-13;CLI00305;FACTURA;27;2;98672;18748;117420
FAC0033754;2015-03-24;CLI00936;FACTURA;15;1;22639;4301;26940
FAC0033755;2015-02-24;CLI00708;FACTURA;25;1;50946;9680;60626
FAC0033756;2015-08-05;CLI00724;FACTURA;45;1;66381;12612;78993
FAC0033757;2015-05-26;CLI00399;FACTURA;38;2;136740;25981;162721
FAC0033758;2015-05-10;CLI00871;FACTURA;43;2;197344;37495;234839
FAC0033759;2015-03-29;CLI00290;FACTURA;42;1;34804;6613;41417
FAC0033760;2015-06-03;CLI00312;FACTURA;7;1;168936;32098;201034
FAC0033761;2015-02-18;CLI00122;FACTURA;1;1;15892;3019;18911
FAC0033762;2015-07-19;CLI00357;FACTURA;16;2;22552;4285;26837
FAC0033763;2015-05-14;CLI00826;FACTURA;13;1;28668;5447;34115
FAC0033764;2015-10-15;CLI00960;FACTURA;29;1;106332;20203;126535
FAC0033765;2015-11-27;CLI00808;FACTURA;18;1;217944;41409;259353
FAC0033766;2015-07-06;CLI00612;FACTURA;31;1;103086;19586;122672
FAC0033767;2015-03-08;CLI00399;FACTURA;11;2;27348;5196;32544
FAC0033768;2015-11-13;CLI00763;FACTURA;32;2;176360;33508;209868
FAC0033769;2015-11-07;CLI00804;FACTURA;3;1;142540;27083;169623
FAC0033770;2015-02-23;CLI00581;FACTURA;41;2;39012;7412;46424
FAC0033771;2015-10-01;CLI00804;FACTURA;26;1;56691;10771;67462
FAC0033772;2015-11-12;CLI00166;FACTURA;43;1;294894;56030;350924
FAC0033773;2015-05-04;CLI00804;FACTURA;35;1;160111;30421;190532
FAC0033774;2015-06-17;CLI00526;FACTURA;50;1;254730;48399;303129
FAC0033775;2015-11-12;CLI00473;FACTURA;20;2;65532;12451;77983
FAC0033776;2015-08-14;CLI00140;FACTURA;29;1;174872;33226;208098
FAC0033777;2015-12-11;CLI00923;FACTURA;31;2;18892;3589;22481
FAC0033778;2015-08-21;CLI00030;FACTURA;34;1;170073;32314;202387
FAC0033779;2015-05-29;CLI00708;FACTURA;23;1;341870;64955;406825
FAC0033780;2015-03-18;CLI00922;FACTURA;41;1;24680;4689;29369
FAC0033781;2015-07-16;CLI00485;FACTURA;32;2;101532;19291;120823
FAC0033782;2015-04-17;CLI00514;FACTURA;32;1;42820;8136;50956
FAC0033783;2015-01-03;CLI00737;FACTURA;24;2;102010;19382;121392
FAC0033784;2015-09-23;CLI00769;FACTURA;7;2;281110;53411;334521
FAC0033785;2015-12-01;CLI00071;FACTURA;47;2;56222;10682;66904
FAC0033786;2015-04-15;CLI00433;FACTURA;11;2;78024;14825;92849
FAC0033787;2015-08-14;CLI00312;FACTURA;37;1;18966;3604;22570
FAC0033788;2015-08-05;CLI00681;FACTURA;21;2;101715;19326;121041
FAC0033789;2015-12-13;CLI00712;FACTURA;1;1;104412;19838;124250
FAC0033790;2015-10-08;CLI00471;FACTURA;20;2;14334;2723;17057
FAC0033791;2015-04-05;CLI00796;FACTURA;36;1;9446;1795;11241
FAC0033792;2015-05-10;CLI00331;FACTURA;40;2;63351;12037;75388
FAC0033793;2015-04-09;CLI00832;FACTURA;11;1;84468;16049;100517
FAC0033794;2015-09-16;CLI00779;FACTURA;49;2;101460;19277;120737
FAC0033795;2015-10-11;CLI00728;FACTURA;32;1;113195;21507;134702
FAC0033796;2015-06-28;CLI00094;FACTURA;26;1;262128;49804;311932
FAC0033797;2015-06-18;CLI00611;FACTURA;9;2;151176;28723;179899
FAC0033798;2015-03-22;CLI00705;FACTURA;9;2;57336;10894;68230
FAC0033799;2015-05-18;CLI00508;FACTURA;6;1;43718;8306;52024
FAC0033800;2015-10-01;CLI00073;FACTURA;7;2;71670;13617;85287
FAC0033801;2015-12-05;CLI00993;FACTURA;47;2;137238;26075;163313
FAC0033802;2015-05-30;CLI00100;FACTURA;20;1;52395;9955;62350
FAC0033803;2015-08-24;CLI00060;FACTURA;20;1;177086;33646;210732
FAC0033804;2015-04-10;CLI00362;FACTURA;32;1;228064;43332;271396
FAC0033805;2015-08-20;CLI00339;FACTURA;1;2;47668;9057;56725
FAC0033806;2015-01-17;CLI00503;FACTURA;49;2;9446;1795;11241
FAC0033807;2015-12-20;CLI00700;FACTURA;45;1;278432;52902;331334
FAC0033808;2015-03-08;CLI00118;FACTURA;11;1;108972;20705;129677
FAC0033809;2015-11-14;CLI00599;FACTURA;23;2;208824;39677;248501
FAC0033810;2015-11-05;CLI00917;FACTURA;26;2;31784;6039;37823
FAC0033811;2015-03-27;CLI00912;FACTURA;5;1;61790;11740;73530
FAC0033812;2015-06-23;CLI00550;FACTURA;12;1;8448;1605;10053
FAC0033813;2015-05-01;CLI00243;FACTURA;45;2;88180;16754;104934
FAC0033814;2015-05-30;CLI00317;FACTURA;2;2;176360;33508;209868
FAC0033815;2015-05-09;CLI00509;FACTURA;1;2;40804;7753;48557
FAC0033816;2015-01-29;CLI00960;FACTURA;1;1;24613;4676;29289
FAC0033817;2015-04-15;CLI00082;FACTURA;35;1;178311;33879;212190
FAC0033818;2015-12-01;CLI00914;FACTURA;6;1;176360;33508;209868
FAC0033819;2015-09-29;CLI00873;FACTURA;48;2;294894;56030;350924
FAC0033820;2015-08-29;CLI00465;FACTURA;40;2;68374;12991;81365
FAC0033821;2015-01-08;CLI00614;FACTURA;32;1;101892;19359;121251
FAC0033822;2015-08-15;CLI00193;FACTURA;15;2;203248;38617;241865
FAC0033823;2015-07-17;CLI00221;FACTURA;30;2;12358;2348;14706
FAC0033824;2015-10-17;CLI00857;FACTURA;33;2;136740;25981;162721
FAC0033825;2015-09-14;CLI00259;FACTURA;8;2;270710;51435;322145
FAC0033826;2015-09-27;CLI00257;FACTURA;19;2;196245;37287;233532
FAC0033827;2015-04-22;CLI00809;FACTURA;2;2;109392;20784;130176
FAC0033828;2015-02-27;CLI00108;FACTURA;8;1;173550;32975;206525
FAC0033829;2015-02-21;CLI00833;FACTURA;39;2;29003;5511;34514
FAC0033830;2015-04-12;CLI00475;FACTURA;26;2;145224;27593;172817
FAC0033831;2015-04-05;CLI00120;FACTURA;16;1;87436;16613;104049
FAC0033832;2015-07-31;CLI00935;FACTURA;15;2;195060;37061;232121
FAC0033833;2015-10-06;CLI00079;FACTURA;34;2;335970;63834;399804
FAC0033834;2015-12-12;CLI00443;FACTURA;33;2;50730;9639;60369
FAC0033835;2015-11-27;CLI00901;FACTURA;19;2;54142;10287;64429
FAC0033836;2015-12-25;CLI00757;FACTURA;12;2;34187;6496;40683
FAC0033837;2015-12-31;CLI00688;FACTURA;32;1;42820;8136;50956
FAC0033838;2015-10-14;CLI00596;FACTURA;21;1;71514;13588;85102
FAC0033839;2015-01-25;CLI00559;FACTURA;10;2;192690;36611;229301
FAC0033840;2015-10-14;CLI00846;FACTURA;1;1;26583;5051;31634
FAC0033841;2015-06-18;CLI00033;FACTURA;32;2;10201;1938;12139
FAC0033842;2015-10-24;CLI00740;FACTURA;48;1;114540;21763;136303
FAC0033843;2015-07-24;CLI00428;FACTURA;32;1;108972;20705;129677
FAC0033844;2015-11-02;CLI00527;FACTURA;15;2;137238;26075;163313
FAC0033845;2015-08-19;CLI00124;FACTURA;9;1;228654;43444;272098
FAC0033846;2015-07-13;CLI00791;FACTURA;28;2;205857;39113;244970
FAC0033847;2015-07-26;CLI00167;FACTURA;32;2;45104;8570;53674
FAC0033848;2015-12-23;CLI00508;FACTURA;2;1;43610;8286;51896
FAC0033849;2015-10-16;CLI00745;FACTURA;15;2;232024;44085;276109
FAC0033850;2015-02-04;CLI00930;FACTURA;28;1;95718;18186;113904
FAC0033851;2015-06-19;CLI00804;FACTURA;50;1;50946;9680;60626
FAC0033852;2015-07-27;CLI00405;FACTURA;6;2;63568;12078;75646
FAC0033853;2015-10-14;CLI00463;FACTURA;46;2;100338;19064;119402
FAC0033854;2015-07-26;CLI00184;FACTURA;45;1;145224;27593;172817
FAC0033855;2015-06-26;CLI00221;FACTURA;10;2;126582;24051;150633
FAC0033856;2015-08-26;CLI00442;FACTURA;21;1;277680;52759;330439
FAC0033857;2015-06-01;CLI00319;FACTURA;35;2;151788;28840;180628
FAC0033858;2015-11-26;CLI00362;FACTURA;22;1;246130;46765;292895
FAC0033859;2015-02-23;CLI00410;FACTURA;20;1;68724;13058;81782
FAC0033860;2015-10-12;CLI00369;FACTURA;50;2;73839;14029;87868
FAC0033861;2015-09-04;CLI00408;FACTURA;35;1;285080;54165;339245
FAC0033862;2015-02-17;CLI00782;FACTURA;5;1;105485;20042;125527
FAC0033863;2015-10-03;CLI00055;FACTURA;22;2;243628;46289;289917
FAC0033864;2015-11-13;CLI00317;FACTURA;46;2;211170;40122;251292
FAC0033865;2015-07-30;CLI00210;FACTURA;6;1;95336;18114;113450
FAC0033866;2015-12-14;CLI00971;FACTURA;37;2;96816;18395;115211
FAC0033867;2015-03-04;CLI00050;FACTURA;44;1;101460;19277;120737
FAC0033868;2015-10-31;CLI00907;FACTURA;3;2;16922;3215;20137
FAC0033869;2015-01-18;CLI00368;FACTURA;5;1;29003;5511;34514
FAC0033870;2015-12-23;CLI00570;FACTURA;28;1;75894;14420;90314
FAC0033871;2015-05-02;CLI00482;FACTURA;20;1;50946;9680;60626
FAC0033872;2015-03-29;CLI00380;FACTURA;1;1;278432;52902;331334
FAC0033873;2015-01-10;CLI00223;FACTURA;26;2;81168;15422;96590
FAC0033874;2015-10-12;CLI00810;FACTURA;6;1;100338;19064;119402
FAC0033875;2015-07-26;CLI00288;FACTURA;37;1;341870;64955;406825
FAC0033876;2015-08-25;CLI00135;FACTURA;40;2;172676;32808;205484
FAC0033877;2015-07-20;CLI00116;FACTURA;15;1;114672;21788;136460
FAC0033878;2015-04-20;CLI00050;FACTURA;12;1;60876;11566;72442
FAC0033879;2015-10-28;CLI00303;FACTURA;29;2;39730;7549;47279
FAC0033880;2015-05-27;CLI00216;FACTURA;6;1;128280;24373;152653
FAC0033881;2015-03-02;CLI00775;FACTURA;45;2;161176;30623;191799
FAC0033882;2015-08-26;CLI00910;FACTURA;11;1;50688;9631;60319
FAC0033883;2015-01-26;CLI00637;FACTURA;43;2;132915;25254;158169
FAC0033884;2015-01-15;CLI00689;FACTURA;26;2;32272;6132;38404
FAC0033885;2015-05-06;CLI00860;FACTURA;32;1;159498;30305;189803
FAC0033886;2015-12-11;CLI00187;FACTURA;46;2;64230;12204;76434
FAC0033887;2015-02-10;CLI00812;FACTURA;40;1;120882;22968;143850
FAC0033888;2015-04-06;CLI00998;FACTURA;41;1;21859;4153;26012
FAC0033889;2015-08-23;CLI00264;FACTURA;49;1;138840;26380;165220
FAC0033890;2015-01-31;CLI00572;FACTURA;38;1;196245;37287;233532
FAC0033891;2015-05-21;CLI00519;FACTURA;2;2;27243;5176;32419
FAC0033892;2015-03-25;CLI00094;FACTURA;26;1;10146;1928;12074
FAC0033893;2015-09-16;CLI00722;FACTURA;27;1;290030;55106;345136
FAC0033894;2015-05-18;CLI00506;FACTURA;16;1;53166;10102;63268
FAC0033895;2015-04-14;CLI00229;FACTURA;40;2;40804;7753;48557
FAC0033896;2015-06-30;CLI00770;FACTURA;5;1;152635;29001;181636
FAC0033897;2015-10-10;CLI00415;FACTURA;16;2;60876;11566;72442
FAC0033898;2015-09-09;CLI00048;FACTURA;15;1;6170;1172;7342
FAC0033899;2015-04-01;CLI00640;FACTURA;17;1;145224;27593;172817
FAC0033900;2015-12-19;CLI00686;FACTURA;36;1;186081;35355;221436
FAC0033901;2015-11-11;CLI00759;FACTURA;5;2;147819;28086;175905
FAC0033902;2015-11-18;CLI00773;FACTURA;18;2;40804;7753;48557
FAC0033903;2015-08-11;CLI00266;FACTURA;32;1;94485;17952;112437
FAC0033904;2015-01-20;CLI00132;FACTURA;12;1;96210;18280;114490
FAC0033905;2015-10-15;CLI00782;FACTURA;29;1;28111;5341;33452
FAC0033906;2015-05-28;CLI00189;FACTURA;46;2;222012;42182;264194
FAC0033907;2015-03-02;CLI00049;FACTURA;42;2;123066;23383;146449
FAC0033908;2015-03-12;CLI00626;FACTURA;5;1;268776;51067;319843
FAC0033909;2015-03-27;CLI00920;FACTURA;14;1;83832;15928;99760
FAC0033910;2015-11-17;CLI00840;FACTURA;21;1;28338;5384;33722
FAC0033911;2015-11-03;CLI00640;FACTURA;25;1;143340;27235;170575
FAC0033912;2015-09-07;CLI00619;FACTURA;2;2;117036;22237;139273
FAC0033913;2015-03-14;CLI00625;FACTURA;14;2;128280;24373;152653
FAC0033914;2015-01-18;CLI00669;FACTURA;49;2;81608;15506;97114
FAC0033915;2015-01-02;CLI00714;FACTURA;42;1;153013;29072;182085
FAC0033916;2015-08-26;CLI00895;FACTURA;18;2;50766;9646;60412
FAC0033917;2015-12-13;CLI00241;FACTURA;11;2;174020;33064;207084
FAC0033918;2015-05-07;CLI00140;FACTURA;5;1;90556;17206;107762
FAC0033919;2015-09-16;CLI00803;FACTURA;24;2;120882;22968;143850
FAC0033920;2015-03-12;CLI00765;FACTURA;44;2;152436;28963;181399
FAC0033921;2015-09-09;CLI00565;FACTURA;14;2;50766;9646;60412
FAC0033922;2015-05-30;CLI00892;FACTURA;18;1;246130;46765;292895
FAC0033923;2015-03-15;CLI00493;FACTURA;3;2;50766;9646;60412
FAC0033924;2015-08-02;CLI00116;FACTURA;48;1;149870;28475;178345
FAC0033925;2015-09-24;CLI00465;FACTURA;17;2;170073;32314;202387
FAC0033926;2015-09-29;CLI00967;FACTURA;47;2;158473;30110;188583
FAC0033927;2015-12-03;CLI00265;FACTURA;15;2;175554;33355;208909
FAC0033928;2015-09-24;CLI00470;FACTURA;28;1;11276;2142;13418
FAC0033929;2015-01-25;CLI00092;FACTURA;25;1;81372;15461;96833
FAC0033930;2015-07-27;CLI00042;FACTURA;23;1;290030;55106;345136
FAC0033931;2015-10-31;CLI00506;FACTURA;47;1;208260;39569;247829
FAC0033932;2015-12-19;CLI00145;FACTURA;3;2;203751;38713;242464
FAC0033933;2015-07-04;CLI00230;FACTURA;49;1;61790;11740;73530
FAC0033934;2015-07-28;CLI00802;FACTURA;2;1;111030;21096;132126
FAC0033935;2015-04-07;CLI00956;FACTURA;47;1;218590;41532;260122
FAC0033936;2015-01-04;CLI00433;FACTURA;7;2;137238;26075;163313
FAC0033937;2015-06-15;CLI00520;FACTURA;8;1;101192;19226;120418
FAC0033938;2015-04-16;CLI00551;FACTURA;44;2;84333;16023;100356
FAC0033939;2015-03-09;CLI00388;FACTURA;32;1;42240;8026;50266
FAC0033940;2015-10-03;CLI00807;FACTURA;2;2;139216;26451;165667
FAC0033941;2015-03-26;CLI00988;FACTURA;15;1;130830;24858;155688
FAC0033942;2015-06-15;CLI00632;FACTURA;7;1;56691;10771;67462
FAC0033943;2015-12-16;CLI00385;FACTURA;39;2;50742;9641;60383
FAC0033944;2015-05-19;CLI00246;FACTURA;28;1;261027;49595;310622
FAC0033945;2015-10-13;CLI00871;FACTURA;35;2;40294;7656;47950
FAC0033946;2015-03-08;CLI00005;FACTURA;3;2;141088;26807;167895
FAC0033947;2015-10-17;CLI00752;FACTURA;14;1;226390;43014;269404
FAC0033948;2015-02-04;CLI00808;FACTURA;8;1;62874;11946;74820
FAC0033949;2015-07-30;CLI00354;FACTURA;29;1;30603;5815;36418
FAC0033950;2015-08-19;CLI00996;FACTURA;35;1;48408;9198;57606
FAC0033951;2015-05-02;CLI00694;FACTURA;48;1;177648;33753;211401
FAC0033952;2015-08-25;CLI00692;FACTURA;13;1;19506;3706;23212
FAC0033953;2015-08-31;CLI00722;FACTURA;32;1;58518;11118;69636
FAC0033954;2015-09-08;CLI00659;FACTURA;46;2;22639;4301;26940
FAC0033955;2015-09-27;CLI00751;FACTURA;2;2;196245;37287;233532
FAC0033956;2015-09-26;CLI00423;FACTURA;48;2;61029;11596;72625
FAC0033957;2015-05-26;CLI00706;FACTURA;41;1;25473;4840;30313
FAC0033958;2015-06-19;CLI00292;FACTURA;32;1;122058;23191;145249
FAC0033959;2015-10-03;CLI00709;FACTURA;4;2;47230;8974;56204
FAC0033960;2015-09-28;CLI00261;FACTURA;14;2;162744;30921;193665
FAC0033961;2015-11-04;CLI00726;FACTURA;49;1;81372;15461;96833
FAC0033962;2015-08-19;CLI00672;FACTURA;6;1;110836;21059;131895
FAC0033963;2015-03-29;CLI00450;FACTURA;18;1;98672;18748;117420
FAC0033964;2015-04-22;CLI00108;FACTURA;13;1;246130;46765;292895
FAC0033965;2015-02-05;CLI00234;FACTURA;29;1;28338;5384;33722
FAC0033966;2015-11-29;CLI00428;FACTURA;48;1;43002;8170;51172
FAC0033967;2015-03-04;CLI00758;FACTURA;42;1;67688;12861;80549
FAC0033968;2015-03-23;CLI00901;FACTURA;40;2;100338;19064;119402
FAC0033969;2015-10-05;CLI00805;FACTURA;18;2;75568;14358;89926
FAC0033970;2015-01-15;CLI00028;FACTURA;7;1;312390;59354;371744
FAC0033971;2015-12-20;CLI00144;FACTURA;43;1;177842;33790;211632
FAC0033972;2015-01-12;CLI00721;FACTURA;50;2;341870;64955;406825
FAC0033973;2015-08-02;CLI00023;FACTURA;29;2;18892;3589;22481
FAC0033974;2015-05-24;CLI00301;FACTURA;10;2;63568;12078;75646
FAC0033975;2015-10-25;CLI00086;FACTURA;30;1;32272;6132;38404
FAC0033976;2015-02-16;CLI00814;FACTURA;18;1;196731;37379;234110
FAC0033977;2015-03-31;CLI00890;FACTURA;5;1;54486;10352;64838
FAC0033978;2015-12-26;CLI00920;FACTURA;46;1;170073;32314;202387
FAC0033979;2015-06-20;CLI00892;FACTURA;35;1;145224;27593;172817
FAC0033980;2015-05-02;CLI00417;FACTURA;26;2;136215;25881;162096
FAC0033981;2015-04-11;CLI00381;FACTURA;2;2;228654;43444;272098
FAC0033982;2015-03-09;CLI00907;FACTURA;26;2;171048;32499;203547
FAC0033983;2015-11-08;CLI00654;FACTURA;36;1;20958;3982;24940
FAC0033984;2015-01-26;CLI00583;FACTURA;31;2;21410;4068;25478
FAC0033985;2015-09-09;CLI00524;FACTURA;1;1;147679;28059;175738
FAC0033986;2015-02-09;CLI00669;FACTURA;10;2;174020;33064;207084
FAC0033987;2015-04-22;CLI00089;FACTURA;16;2;24613;4676;29289
FAC0033988;2015-10-12;CLI00012;FACTURA;15;1;116012;22042;138054
FAC0033989;2015-08-05;CLI00387;FACTURA;5;2;188970;35904;224874
FAC0033990;2015-06-25;CLI00258;FACTURA;47;1;18897;3590;22487
FAC0033991;2015-07-17;CLI00092;FACTURA;10;1;48105;9140;57245
FAC0033992;2015-05-14;CLI00376;FACTURA;42;1;63568;12078;75646
FAC0033993;2015-08-01;CLI00548;FACTURA;28;1;239247;45457;284704
FAC0033994;2015-08-07;CLI00338;FACTURA;14;1;61206;11629;72835
FAC0033995;2015-10-30;CLI00552;FACTURA;49;1;47415;9009;56424
FAC0033996;2015-08-30;CLI00092;FACTURA;26;1;156048;29649;185697
FAC0033997;2015-08-06;CLI00612;FACTURA;28;1;85014;16153;101167
FAC0033998;2015-10-13;CLI00517;FACTURA;16;2;98672;18748;117420
FAC0033999;2015-09-02;CLI00441;FACTURA;3;2;216568;41148;257716
FAC0034000;2015-11-15;CLI00755;FACTURA;41;2;193963;36853;230816
FAC0034001;2015-02-22;CLI00654;FACTURA;45;1;142401;27056;169457
FAC0034002;2015-10-13;CLI00532;FACTURA;1;1;152838;29039;181877
FAC0034003;2015-06-30;CLI00782;FACTURA;37;1;25298;4807;30105
FAC0034004;2015-09-27;CLI00698;FACTURA;27;1;203751;38713;242464
FAC0034005;2015-02-15;CLI00240;FACTURA;9;1;91314;17350;108664
FAC0034006;2015-01-20;CLI00653;FACTURA;6;2;224888;42729;267617
FAC0034007;2015-08-29;CLI00278;FACTURA;34;1;197344;37495;234839
FAC0034008;2015-02-16;CLI00799;FACTURA;40;2;45746;8692;54438
FAC0034009;2015-03-07;CLI00199;FACTURA;20;2;246680;46869;293549
FAC0034010;2015-04-28;CLI00761;FACTURA;45;2;137238;26075;163313
FAC0034011;2015-02-25;CLI00189;FACTURA;36;2;16035;3047;19082
FAC0034012;2015-06-30;CLI00253;FACTURA;22;2;106332;20203;126535
FAC0034013;2015-03-20;CLI00720;FACTURA;49;1;24668;4687;29355
FAC0034014;2015-09-11;CLI00812;FACTURA;42;1;192690;36611;229301
FAC0034015;2015-04-25;CLI00298;FACTURA;45;1;222060;42191;264251
FAC0034016;2015-10-28;CLI00291;FACTURA;1;2;28111;5341;33452
FAC0034017;2015-05-15;CLI00801;FACTURA;46;2;221672;42118;263790
FAC0034018;2015-09-10;CLI00090;FACTURA;30;1;20402;3876;24278
FAC0034019;2015-02-07;CLI00063;FACTURA;32;2;54696;10392;65088
FAC0034020;2015-10-06;CLI00810;FACTURA;35;1;32766;6226;38992
FAC0034021;2015-03-10;CLI00578;FACTURA;29;1;48408;9198;57606
FAC0034022;2015-05-10;CLI00103;FACTURA;50;2;9483;1802;11285
FAC0034023;2015-09-13;CLI00918;FACTURA;6;1;158473;30110;188583
FAC0034024;2015-12-13;CLI00073;FACTURA;22;2;160111;30421;190532
FAC0034025;2015-12-06;CLI00523;FACTURA;42;2;114365;21729;136094
FAC0034026;2015-01-07;CLI00153;FACTURA;33;2;104790;19910;124700
FAC0034027;2015-08-10;CLI00045;FACTURA;41;2;152298;28937;181235
FAC0034028;2015-02-19;CLI00924;FACTURA;42;1;105485;20042;125527
FAC0034029;2015-11-27;CLI00463;FACTURA;32;2;205122;38973;244095
FAC0034030;2015-12-18;CLI00511;FACTURA;4;2;243639;46291;289930
FAC0034031;2015-03-26;CLI00408;FACTURA;29;1;42234;8024;50258
FAC0034032;2015-08-30;CLI00290;FACTURA;30;1;136740;25981;162721
FAC0034033;2015-10-27;CLI00276;FACTURA;2;1;173550;32975;206525
FAC0034034;2015-10-24;CLI00979;FACTURA;46;2;203021;38574;241595
FAC0034035;2015-08-02;CLI00403;FACTURA;39;2;243628;46289;289917
FAC0034036;2015-12-22;CLI00563;FACTURA;48;2;111030;21096;132126
FAC0034037;2015-08-14;CLI00927;FACTURA;31;2;171048;32499;203547
FAC0034038;2015-04-27;CLI00438;FACTURA;40;1;80588;15312;95900
FAC0034039;2015-04-10;CLI00710;FACTURA;16;1;228730;43459;272189
FAC0034040;2015-05-20;CLI00747;FACTURA;50;2;67688;12861;80549
FAC0034041;2015-06-15;CLI00245;FACTURA;21;2;57270;10881;68151
FAC0034042;2015-06-16;CLI00690;FACTURA;9;1;151176;28723;179899
FAC0034043;2015-10-27;CLI00789;FACTURA;7;2;182984;34767;217751
FAC0034044;2015-03-22;CLI00082;FACTURA;7;1;174440;33144;207584
FAC0034045;2015-08-11;CLI00874;FACTURA;7;1;50742;9641;60383
FAC0034046;2015-01-14;CLI00851;FACTURA;10;2;68374;12991;81365
FAC0034047;2015-11-21;CLI00456;FACTURA;40;1;64140;12187;76327
FAC0034048;2015-02-08;CLI00688;FACTURA;14;1;114032;21666;135698
FAC0034049;2015-02-20;CLI00499;FACTURA;30;2;91809;17444;109253
FAC0034050;2015-06-27;CLI00086;FACTURA;50;1;205122;38973;244095
FAC0034051;2015-08-25;CLI00772;FACTURA;14;1;91314;17350;108664
FAC0034052;2015-07-23;CLI00685;FACTURA;47;2;41022;7794;48816
FAC0034053;2015-01-16;CLI00134;FACTURA;43;1;29003;5511;34514
FAC0034054;2015-01-23;CLI00034;FACTURA;36;1;21859;4153;26012
FAC0034055;2015-03-25;CLI00093;FACTURA;49;2;347100;65949;413049
FAC0034056;2015-04-30;CLI00943;FACTURA;11;2;62874;11946;74820
FAC0034057;2015-09-08;CLI00723;FACTURA;7;2;136215;25881;162096
FAC0034058;2015-06-14;CLI00914;FACTURA;22;1;197344;37495;234839
FAC0034059;2015-01-11;CLI00042;FACTURA;43;1;147678;28059;175737
FAC0034060;2015-01-07;CLI00904;FACTURA;21;1;51005;9691;60696
FAC0034061;2015-04-30;CLI00773;FACTURA;48;2;195060;37061;232121
FAC0034062;2015-06-18;CLI00846;FACTURA;7;1;98452;18706;117158
FAC0034063;2015-12-10;CLI00273;FACTURA;38;2;64140;12187;76327
FAC0034064;2015-10-11;CLI00470;FACTURA;26;1;80680;15329;96009
FAC0034065;2015-05-16;CLI00299;FACTURA;1;2;25473;4840;30313
FAC0034066;2015-11-12;CLI00552;FACTURA;6;1;42234;8024;50258
FAC0034067;2015-01-12;CLI00694;FACTURA;6;1;87436;16613;104049
FAC0034068;2015-10-05;CLI00252;FACTURA;11;1;16035;3047;19082
FAC0034069;2015-02-22;CLI00445;FACTURA;38;2;34187;6496;40683
FAC0034070;2015-01-27;CLI00207;FACTURA;39;2;16922;3215;20137
FAC0034071;2015-06-09;CLI00088;FACTURA;29;1;226390;43014;269404
FAC0034072;2015-07-11;CLI00371;FACTURA;18;2;249381;47382;296763
FAC0034073;2015-10-04;CLI00210;FACTURA;13;1;49360;9378;58738
FAC0034074;2015-09-06;CLI00152;FACTURA;6;1;107050;20340;127390
FAC0034075;2015-02-16;CLI00133;FACTURA;46;2;59585;11321;70906
FAC0034076;2015-02-21;CLI00983;FACTURA;3;2;261027;49595;310622
FAC0034077;2015-07-30;CLI00455;FACTURA;32;2;108284;20574;128858
FAC0034078;2015-05-18;CLI00912;FACTURA;26;1;210970;40084;251054
FAC0034079;2015-05-18;CLI00714;FACTURA;20;1;218050;41430;259480
FAC0034080;2015-12-30;CLI00490;FACTURA;10;1;147679;28059;175738
FAC0034081;2015-10-07;CLI00884;FACTURA;1;1;83419;15850;99269
FAC0034082;2015-05-17;CLI00062;FACTURA;37;1;348040;66128;414168
FAC0034083;2015-02-06;CLI00565;FACTURA;12;2;181112;34411;215523
FAC0034084;2015-11-29;CLI00132;FACTURA;4;1;11454;2176;13630
FAC0034085;2015-03-11;CLI00972;FACTURA;6;1;159498;30305;189803
FAC0034086;2015-09-20;CLI00796;FACTURA;23;1;84610;16076;100686
FAC0034087;2015-02-09;CLI00966;FACTURA;49;1;67917;12904;80821
FAC0034088;2015-11-03;CLI00666;FACTURA;46;1;35272;6702;41974
FAC0034089;2015-12-02;CLI00095;FACTURA;22;2;63291;12025;75316
FAC0034090;2015-06-29;CLI00074;FACTURA;46;1;167985;31917;199902
FAC0034091;2015-06-14;CLI00888;FACTURA;41;1;35272;6702;41974
FAC0034092;2015-02-10;CLI00272;FACTURA;23;1;239247;45457;284704
FAC0034093;2015-04-17;CLI00615;FACTURA;36;2;108972;20705;129677
FAC0034094;2015-08-15;CLI00517;FACTURA;26;2;189873;36076;225949
FAC0034095;2015-09-17;CLI00826;FACTURA;7;1;67917;12904;80821
FAC0034096;2015-03-09;CLI00300;FACTURA;39;1;10146;1928;12074
FAC0034097;2015-10-06;CLI00513;FACTURA;38;2;105485;20042;125527
FAC0034098;2015-11-12;CLI00459;FACTURA;20;2;75894;14420;90314
FAC0034099;2015-06-25;CLI00918;FACTURA;4;1;64230;12204;76434
FAC0034100;2015-11-07;CLI00581;FACTURA;3;2;66122;12563;78685
FAC0034101;2015-06-21;CLI00781;FACTURA;24;2;15892;3019;18911
FAC0034102;2015-06-29;CLI00915;FACTURA;45;2;23834;4528;28362
FAC0034103;2015-05-12;CLI00748;FACTURA;20;1;11917;2264;14181
FAC0034104;2015-02-19;CLI00741;FACTURA;30;2;10146;1928;12074
FAC0034105;2015-11-21;CLI00085;FACTURA;33;2;312390;59354;371744
FAC0034106;2015-12-17;CLI00320;FACTURA;34;1;114032;21666;135698
FAC0034107;2015-08-29;CLI00847;FACTURA;49;2;55418;10529;65947
FAC0034108;2015-09-20;CLI00390;FACTURA;37;1;199556;37916;237472
FAC0034109;2015-03-05;CLI00133;FACTURA;25;2;131154;24919;156073
FAC0034110;2015-11-04;CLI00130;FACTURA;7;1;87436;16613;104049
FAC0034111;2015-03-23;CLI00807;FACTURA;38;2;45816;8705;54521
FAC0034112;2015-05-08;CLI00418;FACTURA;25;1;105816;20105;125921
FAC0034113;2015-06-02;CLI00243;FACTURA;42;2;182984;34767;217751
FAC0034114;2015-07-25;CLI00749;FACTURA;49;2;174872;33226;208098
FAC0034115;2015-02-16;CLI00154;FACTURA;13;1;294894;56030;350924
FAC0034116;2015-05-26;CLI00441;FACTURA;6;2;69420;13190;82610
FAC0034117;2015-01-30;CLI00697;FACTURA;48;2;347100;65949;413049
FAC0034118;2015-05-05;CLI00874;FACTURA;6;1;22908;4353;27261
FAC0034119;2015-10-25;CLI00162;FACTURA;47;1;177086;33646;210732
FAC0034120;2015-06-23;CLI00558;FACTURA;45;1;11276;2142;13418
FAC0034121;2015-10-21;CLI00537;FACTURA;28;2;17636;3351;20987
FAC0034122;2015-07-31;CLI00373;FACTURA;14;2;94830;18018;112848
FAC0034123;2015-09-01;CLI00375;FACTURA;17;2;84480;16051;100531
FAC0034124;2015-07-28;CLI00091;FACTURA;5;2;102561;19487;122048
FAC0034125;2015-11-22;CLI00685;FACTURA;50;2;13674;2598;16272
FAC0034126;2015-02-13;CLI00259;FACTURA;40;2;100338;19064;119402
FAC0034127;2015-02-18;CLI00509;FACTURA;36;2;109295;20766;130061
FAC0034128;2015-12-21;CLI00214;FACTURA;9;1;75894;14420;90314
FAC0034129;2015-11-19;CLI00402;FACTURA;22;1;50596;9613;60209
FAC0034130;2015-04-03;CLI00706;FACTURA;50;1;50730;9639;60369
FAC0034131;2015-02-24;CLI00697;FACTURA;40;2;211170;40122;251292
FAC0034132;2015-02-07;CLI00208;FACTURA;44;1;114672;21788;136460
FAC0034133;2015-08-22;CLI00137;FACTURA;49;2;65577;12460;78037
FAC0034134;2015-05-13;CLI00547;FACTURA;26;2;161176;30623;191799
FAC0034135;2015-05-30;CLI00310;FACTURA;18;1;33844;6430;40274
FAC0034136;2015-07-09;CLI00109;FACTURA;16;2;58006;11021;69027
FAC0034137;2015-04-21;CLI00077;FACTURA;8;2;205122;38973;244095
FAC0034138;2015-01-25;CLI00460;FACTURA;36;1;20147;3828;23975
FAC0034139;2015-11-12;CLI00840;FACTURA;25;1;217944;41409;259353
FAC0034140;2015-01-29;CLI00088;FACTURA;12;1;91492;17383;108875
FAC0034141;2015-01-25;CLI00592;FACTURA;34;1;162426;30861;193287
FAC0034142;2015-12-10;CLI00984;FACTURA;9;1;91492;17383;108875
FAC0034143;2015-11-06;CLI00469;FACTURA;12;2;80178;15234;95412
FAC0034144;2015-05-04;CLI00815;FACTURA;5;2;104130;19785;123915
FAC0034145;2015-06-11;CLI00247;FACTURA;7;2;51005;9691;60696
FAC0034146;2015-12-12;CLI00866;FACTURA;25;1;83127;15794;98921
FAC0034147;2015-12-10;CLI00027;FACTURA;11;2;83832;15928;99760
FAC0034148;2015-07-02;CLI00849;FACTURA;48;2;130830;24858;155688
FAC0034149;2015-08-23;CLI00815;FACTURA;2;2;53166;10102;63268
FAC0034150;2015-03-11;CLI00678;FACTURA;27;1;158724;30158;188882
FAC0034151;2015-02-13;CLI00789;FACTURA;29;2;49336;9374;58710
FAC0034152;2015-05-05;CLI00018;FACTURA;27;1;190053;36110;226163
FAC0034153;2015-03-17;CLI00721;FACTURA;19;2;19506;3706;23212
FAC0034154;2015-06-01;CLI00723;FACTURA;25;2;130830;24858;155688
FAC0034155;2015-11-26;CLI00321;FACTURA;40;2;45278;8603;53881
FAC0034156;2015-03-02;CLI00954;FACTURA;2;1;32070;6093;38163
FAC0034157;2015-11-18;CLI00133;FACTURA;8;2;221672;42118;263790
FAC0034158;2015-06-08;CLI00007;FACTURA;20;2;10146;1928;12074
FAC0034159;2015-08-13;CLI00556;FACTURA;36;1;261027;49595;310622
FAC0034160;2015-04-09;CLI00110;FACTURA;22;1;48105;9140;57245
FAC0034161;2015-03-29;CLI00524;FACTURA;38;1;18897;3590;22487
FAC0034162;2015-01-11;CLI00902;FACTURA;7;1;48408;9198;57606
FAC0034163;2015-09-06;CLI00811;FACTURA;14;2;73353;13937;87290
FAC0034164;2015-09-28;CLI00139;FACTURA;22;2;108284;20574;128858
FAC0034165;2015-06-05;CLI00287;FACTURA;26;2;75568;14358;89926
FAC0034166;2015-03-21;CLI00747;FACTURA;29;2;39466;7499;46965
FAC0034167;2015-12-22;CLI00090;FACTURA;9;1;229362;43579;272941
FAC0034168;2015-03-25;CLI00881;FACTURA;5;2;80175;15233;95408
FAC0034169;2015-12-24;CLI00885;FACTURA;9;2;221517;42088;263605
FAC0034170;2015-03-12;CLI00369;FACTURA;41;2;192690;36611;229301
FAC0034171;2015-07-23;CLI00588;FACTURA;20;1;102561;19487;122048
FAC0034172;2015-10-15;CLI00238;FACTURA;1;1;216568;41148;257716
FAC0034173;2015-09-26;CLI00236;FACTURA;42;1;149870;28475;178345
FAC0034174;2015-04-17;CLI00164;FACTURA;32;1;49336;9374;58710
FAC0034175;2015-12-18;CLI00990;FACTURA;40;1;18892;3589;22481
FAC0034176;2015-06-16;CLI00780;FACTURA;49;1;167985;31917;199902
FAC0034177;2015-12-23;CLI00338;FACTURA;43;1;224888;42729;267617
FAC0034178;2015-03-27;CLI00872;FACTURA;17;1;81729;15529;97258
FAC0034179;2015-10-18;CLI00080;FACTURA;15;1;189873;36076;225949
FAC0034180;2015-07-05;CLI00271;FACTURA;47;2;52908;10053;62961
FAC0034181;2015-01-28;CLI00019;FACTURA;36;2;68374;12991;81365
FAC0034182;2015-04-12;CLI00125;FACTURA;24;2;59585;11321;70906
FAC0034183;2015-08-25;CLI00743;FACTURA;22;2;63568;12078;75646
FAC0034184;2015-03-18;CLI00674;FACTURA;11;1;45278;8603;53881
FAC0034185;2015-09-29;CLI00808;FACTURA;11;1;94830;18018;112848
FAC0034186;2015-09-07;CLI00256;FACTURA;43;1;84333;16023;100356
FAC0034187;2015-01-17;CLI00746;FACTURA;48;1;21117;4012;25129
FAC0034188;2015-12-15;CLI00016;FACTURA;31;1;138840;26380;165220
FAC0034189;2015-06-26;CLI00852;FACTURA;38;1;262128;49804;311932
FAC0034190;2015-06-06;CLI00202;FACTURA;30;1;254060;48271;302331
FAC0034191;2015-09-25;CLI00505;FACTURA;23;2;25406;4827;30233
FAC0034192;2015-11-14;CLI00759;FACTURA;28;2;140555;26705;167260
FAC0034193;2015-07-25;CLI00077;FACTURA;27;2;21410;4068;25478
FAC0034194;2015-10-20;CLI00032;FACTURA;20;1;75588;14362;89950
FAC0034195;2015-05-22;CLI00832;FACTURA;37;1;239247;45457;284704
FAC0034196;2015-07-26;CLI00582;FACTURA;20;1;285080;54165;339245
FAC0034197;2015-03-28;CLI00668;FACTURA;24;1;68370;12990;81360
FAC0034198;2015-04-22;CLI00720;FACTURA;37;1;196777;37388;234165
FAC0034199;2015-11-21;CLI00130;FACTURA;14;1;312390;59354;371744
FAC0034200;2015-12-18;CLI00683;FACTURA;38;2;52908;10053;62961
FAC0034201;2015-08-27;CLI00369;FACTURA;10;2;102010;19382;121392
FAC0034202;2015-01-16;CLI00328;FACTURA;11;1;105585;20061;125646
FAC0034203;2015-09-03;CLI00786;FACTURA;22;1;135376;25721;161097
FAC0034204;2015-04-05;CLI00297;FACTURA;11;2;145224;27593;172817
FAC0034205;2015-04-13;CLI00178;FACTURA;39;1;152298;28937;181235
FAC0034206;2015-07-24;CLI00917;FACTURA;49;2;113195;21507;134702
FAC0034207;2015-07-18;CLI00148;FACTURA;6;1;50742;9641;60383
FAC0034208;2015-08-19;CLI00694;FACTURA;41;1;218050;41430;259480
FAC0034209;2015-08-13;CLI00123;FACTURA;28;2;123066;23383;146449
FAC0034210;2015-06-25;CLI00578;FACTURA;3;1;312390;59354;371744
FAC0034211;2015-09-24;CLI00081;FACTURA;9;2;85640;16272;101912
FAC0034212;2015-11-29;CLI00538;FACTURA;18;1;86004;16341;102345
FAC0034213;2015-08-06;CLI00611;FACTURA;41;2;104412;19838;124250
FAC0034214;2015-12-30;CLI00908;FACTURA;22;1;256572;48749;305321
FAC0034215;2015-10-14;CLI00147;FACTURA;49;2;47230;8974;56204
FAC0034216;2015-07-18;CLI00170;FACTURA;2;1;71407;13567;84974
FAC0034217;2015-08-29;CLI00820;FACTURA;18;1;42194;8017;50211
FAC0034218;2015-01-30;CLI00624;FACTURA;19;1;136542;25943;162485
FAC0034219;2015-01-20;CLI00231;FACTURA;20;2;45278;8603;53881
FAC0034220;2015-10-18;CLI00197;FACTURA;20;2;11917;2264;14181
FAC0034221;2015-02-23;CLI00009;FACTURA;13;2;95718;18186;113904
FAC0034222;2015-05-19;CLI00760;FACTURA;41;1;100735;19140;119875
FAC0034223;2015-06-29;CLI00328;FACTURA;16;1;138545;26324;164869
FAC0034224;2015-08-09;CLI00958;FACTURA;24;1;94830;18018;112848
FAC0034225;2015-01-15;CLI00514;FACTURA;29;1;104412;19838;124250
FAC0034226;2015-12-08;CLI00513;FACTURA;23;2;61790;11740;73530
FAC0034227;2015-12-03;CLI00832;FACTURA;3;1;37784;7179;44963
FAC0034228;2015-04-14;CLI00514;FACTURA;50;1;226390;43014;269404
FAC0034229;2015-05-18;CLI00404;FACTURA;21;1;273496;51964;325460
FAC0034230;2015-09-20;CLI00244;FACTURA;14;1;85524;16250;101774
FAC0034231;2015-09-10;CLI00589;FACTURA;44;2;174020;33064;207084
FAC0034232;2015-09-14;CLI00077;FACTURA;32;2;48105;9140;57245
FAC0034233;2015-01-09;CLI00657;FACTURA;50;2;182984;34767;217751
FAC0034234;2015-03-27;CLI00937;FACTURA;27;2;123065;23382;146447
FAC0034235;2015-06-21;CLI00950;FACTURA;48;1;273496;51964;325460
FAC0034236;2015-02-19;CLI00911;FACTURA;47;2;196731;37379;234110
FAC0034237;2015-12-11;CLI00354;FACTURA;9;1;281110;53411;334521
FAC0034238;2015-10-18;CLI00730;FACTURA;3;1;33844;6430;40274
FAC0034239;2015-01-02;CLI00367;FACTURA;15;2;348040;66128;414168
FAC0034240;2015-12-15;CLI00386;FACTURA;45;1;16896;3210;20106
FAC0034241;2015-10-08;CLI00594;FACTURA;47;1;106332;20203;126535
FAC0034242;2015-03-02;CLI00939;FACTURA;20;2;34187;6496;40683
FAC0034243;2015-01-20;CLI00020;FACTURA;10;1;210970;40084;251054
FAC0034244;2015-12-11;CLI00286;FACTURA;33;1;26583;5051;31634
FAC0034245;2015-01-18;CLI00769;FACTURA;47;2;218050;41430;259480
FAC0034246;2015-03-18;CLI00467;FACTURA;37;2;37020;7034;44054
FAC0034247;2015-07-11;CLI00302;FACTURA;6;1;83419;15850;99269
FAC0034248;2015-01-18;CLI00631;FACTURA;38;2;17636;3351;20987
FAC0034249;2015-11-10;CLI00011;FACTURA;2;2;272430;51762;324192
FAC0034250;2015-07-26;CLI00328;FACTURA;45;1;112444;21364;133808
FAC0034251;2015-02-15;CLI00051;FACTURA;19;2;174018;33063;207081
FAC0034252;2015-01-09;CLI00847;FACTURA;9;2;45278;8603;53881
FAC0034253;2015-10-24;CLI00315;FACTURA;37;2;232024;44085;276109
FAC0034254;2015-05-02;CLI00254;FACTURA;43;1;55530;10551;66081
FAC0034255;2015-09-19;CLI00370;FACTURA;27;1;134388;25534;159922
FAC0034256;2015-01-12;CLI00329;FACTURA;20;2;83419;15850;99269
FAC0034257;2015-03-19;CLI00275;FACTURA;7;2;91632;17410;109042
FAC0034258;2015-02-15;CLI00056;FACTURA;38;1;88180;16754;104934
FAC0034259;2015-02-25;CLI00617;FACTURA;24;2;348040;66128;414168
FAC0034260;2015-11-26;CLI00960;FACTURA;39;1;25344;4815;30159
FAC0034261;2015-08-04;CLI00358;FACTURA;23;1;216568;41148;257716
FAC0034262;2015-11-19;CLI00661;FACTURA;11;2;39012;7412;46424
FAC0034263;2015-01-13;CLI00617;FACTURA;6;2;33844;6430;40274
FAC0034264;2015-09-24;CLI00775;FACTURA;14;2;21805;4143;25948
FAC0034265;2015-07-23;CLI00297;FACTURA;2;2;202384;38453;240837
FAC0034266;2015-02-28;CLI00931;FACTURA;31;2;60441;11484;71925
FAC0034267;2015-11-25;CLI00710;FACTURA;4;1;91809;17444;109253
FAC0034268;2015-11-21;CLI00090;FACTURA;29;1;65577;12460;78037
FAC0034269;2015-10-20;CLI00471;FACTURA;3;2;91632;17410;109042
FAC0034270;2015-09-29;CLI00586;FACTURA;20;1;30850;5862;36712
FAC0034271;2015-05-24;CLI00201;FACTURA;41;2;84610;16076;100686
FAC0034272;2015-07-20;CLI00148;FACTURA;18;1;246130;46765;292895
FAC0034273;2015-08-05;CLI00602;FACTURA;37;1;224888;42729;267617
FAC0034274;2015-10-24;CLI00163;FACTURA;40;2;98298;18677;116975
FAC0034275;2015-12-01;CLI00303;FACTURA;32;2;151176;28723;179899
FAC0034276;2015-01-30;CLI00198;FACTURA;9;1;151176;28723;179899
FAC0034277;2015-04-06;CLI00682;FACTURA;36;1;327660;62255;389915
FAC0034278;2015-04-12;CLI00255;FACTURA;2;2;11276;2142;13418
FAC0034279;2015-12-27;CLI00277;FACTURA;11;2;56691;10771;67462
FAC0034280;2015-09-30;CLI00808;FACTURA;43;1;108972;20705;129677
FAC0034281;2015-11-14;CLI00842;FACTURA;14;1;228064;43332;271396
FAC0034282;2015-05-02;CLI00782;FACTURA;17;1;129088;24527;153615
FAC0034283;2015-05-31;CLI00728;FACTURA;15;1;133236;25315;158551
FAC0034284;2015-04-12;CLI00518;FACTURA;19;1;33792;6420;40212
FAC0034285;2015-12-11;CLI00378;FACTURA;32;1;76218;14481;90699
FAC0034286;2015-08-01;CLI00410;FACTURA;30;1;228730;43459;272189
FAC0034287;2015-01-31;CLI00291;FACTURA;50;2;8448;1605;10053
FAC0034288;2015-12-10;CLI00216;FACTURA;44;1;101460;19277;120737
FAC0034289;2015-07-20;CLI00276;FACTURA;35;1;35272;6702;41974
FAC0034290;2015-05-06;CLI00488;FACTURA;41;1;33597;6383;39980
FAC0034291;2015-01-28;CLI00344;FACTURA;17;1;105485;20042;125527
FAC0034292;2015-07-27;CLI00160;FACTURA;32;1;68724;13058;81782
FAC0034293;2015-02-14;CLI00307;FACTURA;18;2;143340;27235;170575
FAC0034294;2015-01-27;CLI00635;FACTURA;28;2;181112;34411;215523
FAC0034295;2015-03-03;CLI00312;FACTURA;21;1;123452;23456;146908
FAC0034296;2015-01-23;CLI00468;FACTURA;7;1;50596;9613;60209
FAC0034297;2015-05-30;CLI00654;FACTURA;31;1;147678;28059;175737
FAC0034298;2015-12-26;CLI00604;FACTURA;46;1;112952;21461;134413
FAC0034299;2015-10-28;CLI00502;FACTURA;31;1;56676;10768;67444
FAC0034300;2015-06-20;CLI00870;FACTURA;1;1;85347;16216;101563
FAC0034301;2015-03-27;CLI00179;FACTURA;19;2;73353;13937;87290
FAC0034302;2015-12-10;CLI00075;FACTURA;25;2;18966;3604;22570
FAC0034303;2015-01-23;CLI00998;FACTURA;38;1;196245;37287;233532
FAC0034304;2015-07-11;CLI00798;FACTURA;37;1;229362;43579;272941
FAC0034305;2015-02-09;CLI00246;FACTURA;2;1;87436;16613;104049
FAC0034306;2015-06-23;CLI00003;FACTURA;15;2;175554;33355;208909
FAC0034307;2015-01-06;CLI00758;FACTURA;35;1;50730;9639;60369
FAC0034308;2015-06-09;CLI00109;FACTURA;1;2;172676;32808;205484
FAC0034309;2015-09-11;CLI00866;FACTURA;39;1;80175;15233;95408
FAC0034310;2015-09-14;CLI00107;FACTURA;33;2;174020;33064;207084
FAC0034311;2015-07-11;CLI00756;FACTURA;31;1;85347;16216;101563
FAC0034312;2015-05-17;CLI00879;FACTURA;30;2;55418;10529;65947
FAC0034313;2015-07-11;CLI00743;FACTURA;8;2;58006;11021;69027
FAC0034314;2015-03-27;CLI00421;FACTURA;3;2;174872;33226;208098
FAC0034315;2015-10-13;CLI00543;FACTURA;42;2;201582;38301;239883
FAC0034316;2015-06-13;CLI00546;FACTURA;41;1;201582;38301;239883
FAC0034317;2015-06-04;CLI00310;FACTURA;6;1;54696;10392;65088
FAC0034318;2015-06-16;CLI00603;FACTURA;27;2;35751;6793;42544
FAC0034319;2015-08-10;CLI00061;FACTURA;5;2;15892;3019;18911
FAC0034320;2015-05-28;CLI00472;FACTURA;6;1;242970;46164;289134
FAC0034321;2015-11-03;CLI00376;FACTURA;50;1;174020;33064;207084
FAC0034322;2015-12-01;CLI00173;FACTURA;42;2;85014;16153;101167
FAC0034323;2015-08-23;CLI00056;FACTURA;1;1;205122;38973;244095
FAC0034324;2015-01-02;CLI00844;FACTURA;31;1;37074;7044;44118
FAC0034325;2015-04-19;CLI00032;FACTURA;5;1;196596;37353;233949
FAC0034326;2015-02-10;CLI00371;FACTURA;49;2;211170;40122;251292
FAC0034327;2015-11-18;CLI00889;FACTURA;7;2;307683;58460;366143
FAC0034328;2015-02-13;CLI00351;FACTURA;1;2;17636;3351;20987
FAC0034329;2015-01-24;CLI00346;FACTURA;28;1;35751;6793;42544
FAC0034330;2015-11-24;CLI00511;FACTURA;10;2;158473;30110;188583
FAC0034331;2015-05-28;CLI00565;FACTURA;24;2;85347;16216;101563
FAC0034332;2015-03-19;CLI00440;FACTURA;11;1;114365;21729;136094
FAC0034333;2015-11-29;CLI00098;FACTURA;45;1;174020;33064;207084
FAC0034334;2015-06-30;CLI00343;FACTURA;9;2;35272;6702;41974
FAC0034335;2015-05-12;CLI00880;FACTURA;27;1;58006;11021;69027
FAC0034336;2015-03-02;CLI00813;FACTURA;24;2;134388;25534;159922
FAC0034337;2015-10-29;CLI00189;FACTURA;15;2;91314;17350;108664
FAC0034338;2015-07-29;CLI00476;FACTURA;32;1;84468;16049;100517
FAC0034339;2015-11-23;CLI00055;FACTURA;31;2;58006;11021;69027
FAC0034340;2015-04-26;CLI00931;FACTURA;28;2;163458;31057;194515
FAC0034341;2015-01-10;CLI00562;FACTURA;15;1;113382;21543;134925
FAC0034342;2015-04-01;CLI00103;FACTURA;15;2;73839;14029;87868
FAC0034343;2015-03-22;CLI00072;FACTURA;47;1;97530;18531;116061
FAC0034344;2015-06-18;CLI00644;FACTURA;4;1;53166;10102;63268
FAC0034345;2015-12-13;CLI00719;FACTURA;40;2;134388;25534;159922
FAC0034346;2015-02-08;CLI00873;FACTURA;7;2;109295;20766;130061
FAC0034347;2015-09-25;CLI00830;FACTURA;2;1;123065;23382;146447
FAC0034348;2015-09-10;CLI00428;FACTURA;30;1;123340;23435;146775
FAC0034349;2015-11-22;CLI00893;FACTURA;12;2;65415;12429;77844
FAC0034350;2015-11-29;CLI00707;FACTURA;8;2;27071;5143;32214
FAC0034351;2015-04-07;CLI00088;FACTURA;5;1;171280;32543;203823
FAC0034352;2015-12-01;CLI00165;FACTURA;16;2;199854;37972;237826
FAC0034353;2015-10-15;CLI00492;FACTURA;21;1;100338;19064;119402
FAC0034354;2015-03-08;CLI00827;FACTURA;42;2;30895;5870;36765
FAC0034355;2015-09-10;CLI00657;FACTURA;2;2;59585;11321;70906
FAC0034356;2015-12-25;CLI00359;FACTURA;1;2;109295;20766;130061
FAC0034357;2015-08-14;CLI00025;FACTURA;40;2;52908;10053;62961
FAC0034358;2015-10-15;CLI00389;FACTURA;28;2;196777;37388;234165
FAC0034359;2015-09-12;CLI00751;FACTURA;50;2;227682;43260;270942
FAC0034360;2015-03-03;CLI00036;FACTURA;15;1;22206;4219;26425
FAC0034361;2015-07-08;CLI00807;FACTURA;21;2;44412;8438;52850
FAC0034362;2015-02-09;CLI00280;FACTURA;7;1;203248;38617;241865
FAC0034363;2015-04-20;CLI00628;FACTURA;33;1;43002;8170;51172
FAC0034364;2015-11-16;CLI00757;FACTURA;18;2;61700;11723;73423
FAC0034365;2015-04-26;CLI00424;FACTURA;26;1;12340;2345;14685
FAC0034366;2015-06-08;CLI00053;FACTURA;11;2;126582;24051;150633
FAC0034367;2015-07-11;CLI00993;FACTURA;8;2;142540;27083;169623
FAC0034368;2015-10-06;CLI00785;FACTURA;28;2;80175;15233;95408
FAC0034369;2015-06-06;CLI00619;FACTURA;39;2;66122;12563;78685
FAC0034370;2015-12-16;CLI00631;FACTURA;4;2;34187;6496;40683
FAC0034371;2015-01-22;CLI00230;FACTURA;5;1;54486;10352;64838
FAC0034372;2015-11-20;CLI00832;FACTURA;46;1;71670;13617;85287
FAC0034373;2015-09-02;CLI00122;FACTURA;24;1;60876;11566;72442
FAC0034374;2015-02-17;CLI00416;FACTURA;16;1;10479;1991;12470
FAC0034375;2015-02-12;CLI00258;FACTURA;3;1;28449;5405;33854
FAC0034376;2015-05-30;CLI00710;FACTURA;21;1;136215;25881;162096
FAC0034377;2015-03-24;CLI00151;FACTURA;41;2;272430;51762;324192
FAC0034378;2015-01-22;CLI00022;FACTURA;39;1;27071;5143;32214
FAC0034379;2015-04-03;CLI00478;FACTURA;25;1;26583;5051;31634
FAC0034380;2015-10-06;CLI00097;FACTURA;47;2;39012;7412;46424
FAC0034381;2015-07-03;CLI00458;FACTURA;1;1;228654;43444;272098
FAC0034382;2015-01-05;CLI00567;FACTURA;43;2;104130;19785;123915
FAC0034383;2015-12-17;CLI00058;FACTURA;11;1;33844;6430;40274
FAC0034384;2015-09-11;CLI00931;FACTURA;21;2;199556;37916;237472
FAC0034385;2015-12-26;CLI00751;FACTURA;4;2;87436;16613;104049
FAC0034386;2015-03-23;CLI00212;FACTURA;33;1;91492;17383;108875
FAC0034387;2015-06-09;CLI00325;FACTURA;42;2;138545;26324;164869
FAC0034388;2015-07-03;CLI00420;FACTURA;25;1;50730;9639;60369
FAC0034389;2015-09-19;CLI00852;FACTURA;42;1;76419;14520;90939
FAC0034390;2015-11-29;CLI00455;FACTURA;3;2;80175;15233;95408
FAC0034391;2015-07-26;CLI00986;FACTURA;39;1;27243;5176;32419
FAC0034392;2015-09-15;CLI00296;FACTURA;6;1;101192;19226;120418
FAC0034393;2015-09-02;CLI00330;FACTURA;41;1;94485;17952;112437
FAC0034394;2015-01-20;CLI00049;FACTURA;38;2;62874;11946;74820
FAC0034395;2015-04-03;CLI00285;FACTURA;27;2;83127;15794;98921
FAC0034396;2015-11-10;CLI00827;FACTURA;5;2;69420;13190;82610
FAC0034397;2015-06-25;CLI00453;FACTURA;47;2;21117;4012;25129
FAC0034398;2015-09-04;CLI00539;FACTURA;35;2;196904;37412;234316
FAC0034399;2015-11-17;CLI00071;FACTURA;31;2;126702;24073;150775
FAC0034400;2015-06-24;CLI00437;FACTURA;43;2;98452;18706;117158
FAC0034401;2015-03-04;CLI00577;FACTURA;30;2;53166;10102;63268
FAC0034402;2015-05-09;CLI00028;FACTURA;6;1;221517;42088;263605
FAC0034403;2015-06-30;CLI00120;FACTURA;33;1;28190;5356;33546
FAC0034404;2015-04-03;CLI00214;FACTURA;39;1;61206;11629;72835
FAC0034405;2015-02-21;CLI00583;FACTURA;13;2;28111;5341;33452
FAC0034406;2015-01-28;CLI00278;FACTURA;16;1;75568;14358;89926
FAC0034407;2015-05-05;CLI00093;FACTURA;45;2;161360;30658;192018
FAC0034408;2015-05-09;CLI00371;FACTURA;25;2;120882;22968;143850
FAC0034409;2015-05-20;CLI00792;FACTURA;39;1;335970;63834;399804
FAC0034410;2015-03-15;CLI00569;FACTURA;19;2;141029;26796;167825
FAC0034411;2015-04-13;CLI00377;FACTURA;8;2;117036;22237;139273
FAC0034412;2015-05-26;CLI00865;FACTURA;44;2;135834;25808;161642
FAC0034413;2015-02-01;CLI00359;FACTURA;49;2;265830;50508;316338
FAC0034414;2015-06-16;CLI00245;FACTURA;30;2;47230;8974;56204
FAC0034415;2015-04-19;CLI00960;FACTURA;2;1;85347;16216;101563
FAC0034416;2015-07-11;CLI00219;FACTURA;8;2;96210;18280;114490
FAC0034417;2015-06-25;CLI00431;FACTURA;5;2;30438;5783;36221
FAC0034418;2015-12-10;CLI00855;FACTURA;42;2;49226;9353;58579
FAC0034419;2015-07-25;CLI00478;FACTURA;44;1;197344;37495;234839
FAC0034420;2015-06-24;CLI00667;FACTURA;40;2;91492;17383;108875
FAC0034421;2015-10-31;CLI00248;FACTURA;5;1;109025;20715;129740
FAC0034422;2015-08-10;CLI00276;FACTURA;40;1;254060;48271;302331
FAC0034423;2015-04-12;CLI00242;FACTURA;47;1;6179;1174;7353
FAC0034424;2015-05-17;CLI00837;FACTURA;19;2;128460;24407;152867
FAC0034425;2015-07-07;CLI01000;FACTURA;50;1;11276;2142;13418
FAC0034426;2015-06-02;CLI00316;FACTURA;7;1;217944;41409;259353
FAC0034427;2015-08-05;CLI00325;FACTURA;8;2;104412;19838;124250
FAC0034428;2015-02-04;CLI00412;FACTURA;27;1;18892;3589;22481
FAC0034429;2015-10-08;CLI00296;FACTURA;49;1;138840;26380;165220
FAC0034430;2015-11-05;CLI00459;FACTURA;12;2;79749;15152;94901
FAC0034431;2015-09-28;CLI00479;FACTURA;26;2;163458;31057;194515
FAC0034432;2015-11-11;CLI00915;FACTURA;34;2;114672;21788;136460
FAC0034433;2015-03-17;CLI00292;FACTURA;20;1;56380;10712;67092
FAC0034434;2015-11-06;CLI00496;FACTURA;29;1;176360;33508;209868
FAC0034435;2015-01-23;CLI00935;FACTURA;25;2;87220;16572;103792
FAC0034436;2015-10-23;CLI00689;FACTURA;18;2;155442;29534;184976
FAC0034437;2015-09-25;CLI00417;FACTURA;4;2;16035;3047;19082
FAC0034438;2015-08-29;CLI00330;FACTURA;21;1;104790;19910;124700
FAC0034439;2015-12-13;CLI00022;FACTURA;5;1;129006;24511;153517
FAC0034440;2015-03-21;CLI00527;FACTURA;35;2;67917;12904;80821
FAC0034441;2015-01-04;CLI00691;FACTURA;10;2;145015;27553;172568
FAC0034442;2015-02-23;CLI00477;FACTURA;3;2;203430;38652;242082
FAC0034443;2015-03-11;CLI00127;FACTURA;20;2;156048;29649;185697
FAC0034444;2015-12-22;CLI00403;FACTURA;34;2;202384;38453;240837
FAC0034445;2015-10-26;CLI00065;FACTURA;41;2;56380;10712;67092
FAC0034446;2015-12-26;CLI00489;FACTURA;34;2;40686;7730;48416
FAC0034447;2015-11-07;CLI00283;FACTURA;39;2;64544;12263;76807
FAC0034448;2015-07-06;CLI00460;FACTURA;39;1;101624;19309;120933
FAC0034449;2015-10-28;CLI00991;FACTURA;10;2;75568;14358;89926
FAC0034450;2015-06-25;CLI00468;FACTURA;49;1;196777;37388;234165
FAC0034451;2015-04-21;CLI00951;FACTURA;19;2;21859;4153;26012
FAC0034452;2015-06-30;CLI00133;FACTURA;4;2;109295;20766;130061
FAC0034453;2015-05-16;CLI00848;FACTURA;34;1;80680;15329;96009
FAC0034454;2015-01-07;CLI00960;FACTURA;21;1;66122;12563;78685
FAC0034455;2015-02-16;CLI00343;FACTURA;3;2;71514;13588;85102
FAC0034456;2015-03-06;CLI00316;FACTURA;29;1;138545;26324;164869
FAC0034457;2015-01-02;CLI00235;FACTURA;9;2;76419;14520;90939
FAC0034458;2015-09-14;CLI00105;FACTURA;9;2;177648;33753;211401
FAC0034459;2015-03-31;CLI00148;FACTURA;25;1;193963;36853;230816
FAC0034460;2015-03-09;CLI00016;FACTURA;49;1;152436;28963;181399
FAC0034461;2015-11-27;CLI00323;FACTURA;42;2;67917;12904;80821
FAC0034462;2015-05-29;CLI00089;FACTURA;47;2;265830;50508;316338
FAC0034463;2015-07-03;CLI00376;FACTURA;3;1;106332;20203;126535
FAC0034464;2015-04-17;CLI00394;FACTURA;5;1;114032;21666;135698
FAC0034465;2015-11-27;CLI00479;FACTURA;12;2;218590;41532;260122
FAC0034466;2015-06-10;CLI00541;FACTURA;27;2;28111;5341;33452
FAC0034467;2015-04-20;CLI00516;FACTURA;39;1;48105;9140;57245
FAC0034468;2015-02-16;CLI00743;FACTURA;43;2;25298;4807;30105
FAC0034469;2015-04-07;CLI00138;FACTURA;7;1;256572;48749;305321
FAC0034470;2015-10-28;CLI00615;FACTURA;38;2;94485;17952;112437
FAC0034471;2015-02-26;CLI00388;FACTURA;7;1;23834;4528;28362
FAC0034472;2015-07-28;CLI00183;FACTURA;2;2;94485;17952;112437
FAC0034473;2015-10-10;CLI00274;FACTURA;22;1;229257;43559;272816
FAC0034474;2015-05-14;CLI00549;FACTURA;11;2;27348;5196;32544
FAC0034475;2015-10-11;CLI00831;FACTURA;5;2;109025;20715;129740
FAC0034476;2015-06-07;CLI00393;FACTURA;32;2;174020;33064;207084
FAC0034477;2015-07-30;CLI00319;FACTURA;22;2;80175;15233;95408
FAC0034478;2015-05-27;CLI00960;FACTURA;46;1;70544;13403;83947
FAC0034479;2015-02-09;CLI00339;FACTURA;46;2;205857;39113;244970
FAC0034480;2015-09-13;CLI00140;FACTURA;35;1;197344;37495;234839
FAC0034481;2015-09-14;CLI00879;FACTURA;9;2;136542;25943;162485
FAC0034482;2015-10-18;CLI00755;FACTURA;19;2;108972;20705;129677
FAC0034483;2015-01-05;CLI00455;FACTURA;8;2;103086;19586;122672
FAC0034484;2015-09-24;CLI00659;FACTURA;48;2;88824;16877;105701
FAC0034485;2015-06-20;CLI00277;FACTURA;24;2;81729;15529;97258
FAC0034486;2015-07-28;CLI00072;FACTURA;2;1;86004;16341;102345
FAC0034487;2015-04-22;CLI00409;FACTURA;44;2;68370;12990;81360
FAC0034488;2015-07-07;CLI00846;FACTURA;17;1;91314;17350;108664
FAC0034489;2015-04-11;CLI00237;FACTURA;4;2;32272;6132;38404
FAC0034490;2015-06-12;CLI00616;FACTURA;1;1;94830;18018;112848
FAC0034491;2015-05-12;CLI00622;FACTURA;1;1;50688;9631;60319
FAC0034492;2015-01-30;CLI00915;FACTURA;23;2;224888;42729;267617
FAC0034493;2015-04-16;CLI00202;FACTURA;12;1;302373;57451;359824
FAC0034494;2015-06-14;CLI00262;FACTURA;48;1;16035;3047;19082
FAC0034495;2015-01-23;CLI00984;FACTURA;28;1;137238;26075;163313
FAC0034496;2015-08-19;CLI00580;FACTURA;42;1;118454;22506;140960
FAC0034497;2015-04-10;CLI00594;FACTURA;29;1;71670;13617;85287
FAC0034498;2015-03-07;CLI00424;FACTURA;30;1;57336;10894;68230
FAC0034499;2015-12-15;CLI00999;FACTURA;47;2;270710;51435;322145
FAC0034500;2015-09-23;CLI00146;FACTURA;15;1;174018;33063;207081
FAC0034501;2015-10-22;CLI00789;FACTURA;40;2;243628;46289;289917
FAC0034502;2015-06-23;CLI00670;FACTURA;45;1;177842;33790;211632
FAC0034503;2015-09-21;CLI00711;FACTURA;6;2;208824;39677;248501
FAC0034504;2015-06-01;CLI00323;FACTURA;40;2;7946;1510;9456
FAC0034505;2015-04-01;CLI00035;FACTURA;23;2;58006;11021;69027
FAC0034506;2015-02-23;CLI00103;FACTURA;7;2;9446;1795;11241
FAC0034507;2015-04-17;CLI00020;FACTURA;48;1;105816;20105;125921
FAC0034508;2015-04-22;CLI00906;FACTURA;45;1;101624;19309;120933
FAC0034509;2015-01-10;CLI00321;FACTURA;33;2;103086;19586;122672
FAC0034510;2015-09-12;CLI00077;FACTURA;1;2;201582;38301;239883
FAC0034511;2015-05-20;CLI00835;FACTURA;3;2;68370;12990;81360
FAC0034512;2015-02-01;CLI00978;FACTURA;31;1;273496;51964;325460
FAC0034513;2015-12-25;CLI00015;FACTURA;7;2;74004;14061;88065
FAC0034514;2015-02-14;CLI00793;FACTURA;3;2;138545;26324;164869
FAC0034515;2015-01-16;CLI00587;FACTURA;42;2;50946;9680;60626
FAC0034516;2015-09-12;CLI00679;FACTURA;23;2;81168;15422;96590
FAC0034517;2015-07-20;CLI00697;FACTURA;40;2;10479;1991;12470
FAC0034518;2015-01-04;CLI00109;FACTURA;5;2;294894;56030;350924
FAC0034519;2015-06-25;CLI00998;FACTURA;9;1;20343;3865;24208
FAC0034520;2015-04-20;CLI00759;FACTURA;25;2;196596;37353;233949
FAC0034521;2015-04-17;CLI00236;FACTURA;22;1;76419;14520;90939
FAC0034522;2015-10-16;CLI01000;FACTURA;17;1;43002;8170;51172
FAC0034523;2015-01-18;CLI00911;FACTURA;39;2;122058;23191;145249
FAC0034524;2015-03-07;CLI00271;FACTURA;22;2;143340;27235;170575
FAC0034525;2015-03-19;CLI00711;FACTURA;22;2;27071;5143;32214
FAC0034526;2015-11-09;CLI00089;FACTURA;23;2;226390;43014;269404
FAC0034527;2015-11-18;CLI00789;FACTURA;9;2;91809;17444;109253
FAC0034528;2015-09-19;CLI00681;FACTURA;5;2;190053;36110;226163
FAC0034529;2015-07-20;CLI00345;FACTURA;50;2;30603;5815;36418
FAC0034530;2015-09-22;CLI00029;FACTURA;38;2;22206;4219;26425
FAC0034531;2015-09-14;CLI00698;FACTURA;45;1;20958;3982;24940
FAC0034532;2015-11-07;CLI00066;FACTURA;29;1;239309;45469;284778
FAC0034533;2015-02-23;CLI00927;FACTURA;13;2;59136;11236;70372
FAC0034534;2015-01-02;CLI00775;FACTURA;11;2;18966;3604;22570
FAC0034535;2015-09-14;CLI00312;FACTURA;40;1;123340;23435;146775
FAC0034536;2015-04-16;CLI00899;FACTURA;14;2;196777;37388;234165
FAC0034537;2015-05-23;CLI00842;FACTURA;26;1;37794;7181;44975
FAC0034538;2015-12-31;CLI00308;FACTURA;17;1;20147;3828;23975
FAC0034539;2015-09-24;CLI00032;FACTURA;28;1;18537;3522;22059
FAC0034540;2015-01-20;CLI00702;FACTURA;42;1;135355;25717;161072
FAC0034541;2015-11-20;CLI00975;FACTURA;11;2;161176;30623;191799
FAC0034542;2015-06-24;CLI00691;FACTURA;46;2;19506;3706;23212
FAC0034543;2015-07-22;CLI00098;FACTURA;22;1;76419;14520;90939
FAC0034544;2015-09-18;CLI00656;FACTURA;5;1;172676;32808;205484
FAC0034545;2015-07-12;CLI00572;FACTURA;35;1;201470;38279;239749
FAC0034546;2015-05-09;CLI00693;FACTURA;45;2;151788;28840;180628
FAC0034547;2015-07-31;CLI00952;FACTURA;14;1;159498;30305;189803
FAC0034548;2015-04-13;CLI00515;FACTURA;14;2;78024;14825;92849
FAC0034549;2015-04-17;CLI00294;FACTURA;40;1;163830;31128;194958
FAC0034550;2015-10-07;CLI00416;FACTURA;15;1;221517;42088;263605
FAC0034551;2015-03-06;CLI00285;FACTURA;42;2;243628;46289;289917
FAC0034552;2015-07-21;CLI00042;FACTURA;2;1;34804;6613;41417
FAC0034553;2015-08-20;CLI00220;FACTURA;12;1;178311;33879;212190
FAC0034554;2015-06-08;CLI00395;FACTURA;28;2;47668;9057;56725
FAC0034555;2015-11-10;CLI00394;FACTURA;49;1;232024;44085;276109
FAC0034556;2015-04-20;CLI00983;FACTURA;1;2;16035;3047;19082
FAC0034557;2015-09-28;CLI00934;FACTURA;37;1;161360;30658;192018
FAC0034558;2015-12-24;CLI00910;FACTURA;29;1;20292;3855;24147
FAC0034559;2015-08-13;CLI00316;FACTURA;8;1;11917;2264;14181
FAC0034560;2015-01-13;CLI00298;FACTURA;19;1;88824;16877;105701
FAC0034561;2015-08-31;CLI00792;FACTURA;15;1;52395;9955;62350
FAC0034562;2015-07-28;CLI00188;FACTURA;43;1;313236;59515;372751
FAC0034563;2015-07-15;CLI00461;FACTURA;26;2;131154;24919;156073
FAC0034564;2015-10-06;CLI00716;FACTURA;24;1;132279;25133;157412
FAC0034565;2015-01-26;CLI00719;FACTURA;49;2;123065;23382;146447
FAC0034566;2015-03-07;CLI00964;FACTURA;25;1;30895;5870;36765
FAC0034567;2015-03-07;CLI00682;FACTURA;7;1;133236;25315;158551
FAC0034568;2015-04-15;CLI00525;FACTURA;3;2;302373;57451;359824
FAC0034569;2015-11-19;CLI00905;FACTURA;23;2;50946;9680;60626
FAC0034570;2015-08-25;CLI00029;FACTURA;12;2;87436;16613;104049
FAC0034571;2015-10-04;CLI00264;FACTURA;2;1;6179;1174;7353
FAC0034572;2015-05-13;CLI00696;FACTURA;41;1;113382;21543;134925
FAC0034573;2015-07-28;CLI00883;FACTURA;22;2;203021;38574;241595
FAC0034574;2015-12-09;CLI00757;FACTURA;49;2;173550;32975;206525
FAC0034575;2015-11-08;CLI00446;FACTURA;40;1;109025;20715;129740
FAC0034576;2015-03-15;CLI00487;FACTURA;32;2;145015;27553;172568
FAC0034577;2015-06-23;CLI00693;FACTURA;9;2;59136;11236;70372
FAC0034578;2015-01-27;CLI00208;FACTURA;26;1;190701;36233;226934
FAC0034579;2015-05-15;CLI00603;FACTURA;6;2;18892;3589;22481
FAC0034580;2015-04-26;CLI00754;FACTURA;25;1;56898;10811;67709
FAC0034581;2015-08-30;CLI00083;FACTURA;43;2;174020;33064;207084
FAC0034582;2015-08-27;CLI00524;FACTURA;5;1;56691;10771;67462
FAC0034583;2015-06-20;CLI00216;FACTURA;11;1;20147;3828;23975
FAC0034584;2015-08-03;CLI00219;FACTURA;1;2;239309;45469;284778
FAC0034585;2015-08-27;CLI00343;FACTURA;38;2;246130;46765;292895
FAC0034586;2015-01-04;CLI00278;FACTURA;18;1;27348;5196;32544
FAC0034587;2015-09-21;CLI00171;FACTURA;32;2;168776;32067;200843
FAC0034588;2015-08-08;CLI00035;FACTURA;33;2;98452;18706;117158
FAC0034589;2015-05-03;CLI00764;FACTURA;4;1;84468;16049;100517
FAC0034590;2015-02-14;CLI00032;FACTURA;46;1;100791;19150;119941
FAC0034591;2015-05-26;CLI00767;FACTURA;33;2;28668;5447;34115
FAC0034592;2015-02-18;CLI00330;FACTURA;9;1;160350;30467;190817
FAC0034593;2015-09-10;CLI00509;FACTURA;28;2;61029;11596;72625
FAC0034594;2015-05-08;CLI00593;FACTURA;31;2;66618;12657;79275
FAC0034595;2015-01-29;CLI00943;FACTURA;2;2;47668;9057;56725
FAC0034596;2015-11-27;CLI00513;FACTURA;24;2;106332;20203;126535
FAC0034597;2015-03-19;CLI00251;FACTURA;30;2;135355;25717;161072
FAC0034598;2015-12-04;CLI00374;FACTURA;7;1;42234;8024;50258
FAC0034599;2015-05-13;CLI00607;FACTURA;23;2;201582;38301;239883
FAC0034600;2015-02-06;CLI00097;FACTURA;50;2;20958;3982;24940
FAC0034601;2015-03-27;CLI00222;FACTURA;35;1;228730;43459;272189
FAC0034602;2015-12-14;CLI00320;FACTURA;33;1;23834;4528;28362
FAC0034603;2015-11-04;CLI00315;FACTURA;21;2;104790;19910;124700
FAC0034604;2015-02-28;CLI00951;FACTURA;49;2;199854;37972;237826
FAC0034605;2015-01-24;CLI00195;FACTURA;26;2;268776;51067;319843
FAC0034606;2015-10-21;CLI00965;FACTURA;50;2;199556;37916;237472
FAC0034607;2015-07-04;CLI00067;FACTURA;16;2;59136;11236;70372
FAC0034608;2015-02-25;CLI00259;FACTURA;20;2;127365;24199;151564
FAC0034609;2015-07-04;CLI00489;FACTURA;28;2;152635;29001;181636
FAC0034610;2015-07-04;CLI00320;FACTURA;13;1;68619;13038;81657
FAC0034611;2015-02-14;CLI00445;FACTURA;42;2;171280;32543;203823
FAC0034612;2015-09-02;CLI00239;FACTURA;31;2;143340;27235;170575
FAC0034613;2015-06-21;CLI00963;FACTURA;14;2;192690;36611;229301
FAC0034614;2015-01-22;CLI00143;FACTURA;26;2;88824;16877;105701
FAC0034615;2015-08-02;CLI00608;FACTURA;39;1;208260;39569;247829
FAC0034616;2015-11-08;CLI00856;FACTURA;47;1;130830;24858;155688
FAC0034617;2015-12-19;CLI00099;FACTURA;35;2;94460;17947;112407
FAC0034618;2015-11-15;CLI00204;FACTURA;37;1;199854;37972;237826
FAC0034619;2015-10-26;CLI00792;FACTURA;30;1;246680;46869;293549
FAC0034620;2015-11-18;CLI00937;FACTURA;30;2;246130;46765;292895
FAC0034621;2015-03-27;CLI00638;FACTURA;8;1;45816;8705;54521
FAC0034622;2015-06-19;CLI00943;FACTURA;37;2;132279;25133;157412
FAC0034623;2015-08-11;CLI00482;FACTURA;20;1;25298;4807;30105
FAC0034624;2015-01-27;CLI00547;FACTURA;10;2;69608;13226;82834
FAC0034625;2015-04-03;CLI00624;FACTURA;22;1;175554;33355;208909
FAC0034626;2015-02-26;CLI00500;FACTURA;6;1;216568;41148;257716
FAC0034627;2015-08-14;CLI00278;FACTURA;6;1;21859;4153;26012
FAC0034628;2015-10-23;CLI00510;FACTURA;7;1;111030;21096;132126
FAC0034629;2015-02-14;CLI00627;FACTURA;35;2;74004;14061;88065
FAC0034630;2015-08-27;CLI00996;FACTURA;35;1;112245;21327;133572
FAC0034631;2015-09-22;CLI00685;FACTURA;32;2;147678;28059;175737
FAC0034632;2015-05-25;CLI00505;FACTURA;45;2;221672;42118;263790
FAC0034633;2015-11-26;CLI00314;FACTURA;40;1;161360;30658;192018
FAC0034634;2015-01-26;CLI00772;FACTURA;6;1;224888;42729;267617
FAC0034635;2015-02-18;CLI00619;FACTURA;20;2;243628;46289;289917
FAC0034636;2015-10-08;CLI00371;FACTURA;34;2;94311;17919;112230
FAC0034637;2015-03-16;CLI00015;FACTURA;31;2;142540;27083;169623
FAC0034638;2015-01-05;CLI00400;FACTURA;40;1;249381;47382;296763
FAC0034639;2015-07-14;CLI00596;FACTURA;16;1;134388;25534;159922
FAC0034640;2015-04-04;CLI00330;FACTURA;4;1;123065;23382;146447
FAC0034641;2015-07-20;CLI00335;FACTURA;29;2;222012;42182;264194
FAC0034642;2015-08-13;CLI00739;FACTURA;12;2;214100;40679;254779
FAC0034643;2015-12-12;CLI00283;FACTURA;4;2;47415;9009;56424
FAC0034644;2015-01-13;CLI00063;FACTURA;11;2;31784;6039;37823
FAC0034645;2015-10-31;CLI00983;FACTURA;41;2;39012;7412;46424
FAC0034646;2015-04-29;CLI00625;FACTURA;32;2;47415;9009;56424
FAC0034647;2015-10-12;CLI00095;FACTURA;4;2;25344;4815;30159
FAC0034648;2015-03-26;CLI00733;FACTURA;13;2;341870;64955;406825
FAC0034649;2015-03-19;CLI00730;FACTURA;28;1;29003;5511;34514
FAC0034650;2015-08-04;CLI00273;FACTURA;35;2;27243;5176;32419
FAC0034651;2015-08-23;CLI00329;FACTURA;41;2;23838;4529;28367
FAC0034652;2015-09-29;CLI00908;FACTURA;26;1;33828;6427;40255
FAC0034653;2015-06-13;CLI00848;FACTURA;35;1;85524;16250;101774
FAC0034654;2015-07-14;CLI00137;FACTURA;20;2;95336;18114;113450
FAC0034655;2015-02-13;CLI00435;FACTURA;23;2;178311;33879;212190
FAC0034656;2015-08-21;CLI00793;FACTURA;23;2;214100;40679;254779
FAC0034657;2015-04-27;CLI00601;FACTURA;40;2;108972;20705;129677
FAC0034658;2015-03-26;CLI00026;FACTURA;48;1;196596;37353;233949
FAC0034659;2015-07-15;CLI00223;FACTURA;42;2;63568;12078;75646
FAC0034660;2015-05-15;CLI00085;FACTURA;49;2;16914;3214;20128
FAC0034661;2015-03-30;CLI00455;FACTURA;38;2;33844;6430;40274
FAC0034662;2015-02-15;CLI00083;FACTURA;23;2;37074;7044;44118
FAC0034663;2015-03-24;CLI00506;FACTURA;44;1;126582;24051;150633
FAC0034664;2015-07-02;CLI00454;FACTURA;28;1;50742;9641;60383
FAC0034665;2015-04-26;CLI00165;FACTURA;36;2;55622;10568;66190
FAC0034666;2015-09-25;CLI00587;FACTURA;19;2;57336;10894;68230
FAC0034667;2015-03-08;CLI00870;FACTURA;28;1;37020;7034;44054
FAC0034668;2015-09-21;CLI00623;FACTURA;13;2;71514;13588;85102
FAC0034669;2015-06-26;CLI00884;FACTURA;42;1;70544;13403;83947
FAC0034670;2015-11-22;CLI00683;FACTURA;5;2;242970;46164;289134
FAC0034671;2015-04-26;CLI00504;FACTURA;46;1;65532;12451;77983
FAC0034672;2015-08-09;CLI00546;FACTURA;6;1;12358;2348;14706
FAC0034673;2015-02-05;CLI00622;FACTURA;2;1;62874;11946;74820
FAC0034674;2015-01-02;CLI00282;FACTURA;3;1;190053;36110;226163
FAC0034675;2015-11-01;CLI00752;FACTURA;31;1;221517;42088;263605
FAC0034676;2015-11-17;CLI00751;FACTURA;35;2;170073;32314;202387
FAC0034677;2015-05-14;CLI00782;FACTURA;16;1;239309;45469;284778
FAC0034678;2015-07-09;CLI00691;FACTURA;32;2;87436;16613;104049
FAC0034679;2015-06-06;CLI00862;FACTURA;16;1;98672;18748;117420
FAC0034680;2015-09-19;CLI00110;FACTURA;32;1;91314;17350;108664
FAC0034681;2015-11-10;CLI00511;FACTURA;7;2;153013;29072;182085
FAC0034682;2015-02-13;CLI00898;FACTURA;16;1;160111;30421;190532
FAC0034683;2015-04-19;CLI00267;FACTURA;33;2;5638;1071;6709
FAC0034684;2015-08-24;CLI00782;FACTURA;8;1;25298;4807;30105
FAC0034685;2015-02-20;CLI00750;FACTURA;26;1;35751;6793;42544
FAC0034686;2015-01-20;CLI00806;FACTURA;5;1;114032;21666;135698
FAC0034687;2015-06-22;CLI00201;FACTURA;26;2;18966;3604;22570
FAC0034688;2015-04-20;CLI00918;FACTURA;25;1;203751;38713;242464
FAC0034689;2015-09-03;CLI00154;FACTURA;26;1;24680;4689;29369
FAC0034690;2015-04-01;CLI00461;FACTURA;48;2;210970;40084;251054
FAC0034691;2015-08-01;CLI00361;FACTURA;47;2;112952;21461;134413
FAC0034692;2015-08-23;CLI00947;FACTURA;14;2;83127;15794;98921
FAC0034693;2015-09-30;CLI00884;FACTURA;27;1;278432;52902;331334
FAC0034694;2015-03-23;CLI00523;FACTURA;4;2;170935;32478;203413
FAC0034695;2015-08-27;CLI00984;FACTURA;7;1;91809;17444;109253
FAC0034696;2015-02-04;CLI00718;FACTURA;18;1;162426;30861;193287
FAC0034697;2015-05-15;CLI00979;FACTURA;49;2;16922;3215;20137
FAC0034698;2015-01-18;CLI00488;FACTURA;6;1;196245;37287;233532
FAC0034699;2015-05-05;CLI00849;FACTURA;8;2;135834;25808;161642
FAC0034700;2015-04-10;CLI00346;FACTURA;15;1;42234;8024;50258
FAC0034701;2015-12-10;CLI00692;FACTURA;10;1;148008;28122;176130
FAC0034702;2015-04-13;CLI00180;FACTURA;27;1;50946;9680;60626
FAC0034703;2015-04-27;CLI00799;FACTURA;7;2;76419;14520;90939
FAC0034704;2015-10-11;CLI00907;FACTURA;39;2;104790;19910;124700
FAC0034705;2015-10-13;CLI00032;FACTURA;9;1;114365;21729;136094
FAC0034706;2015-04-09;CLI00004;FACTURA;30;1;33828;6427;40255
FAC0034707;2015-01-03;CLI00265;FACTURA;5;2;228654;43444;272098
FAC0034708;2015-02-06;CLI00268;FACTURA;9;1;75894;14420;90314
FAC0034709;2015-03-21;CLI00245;FACTURA;35;2;24716;4696;29412
FAC0034710;2015-07-24;CLI00204;FACTURA;19;1;16896;3210;20106
FAC0034711;2015-01-09;CLI00928;FACTURA;49;1;61700;11723;73423
FAC0034712;2015-01-16;CLI00426;FACTURA;30;1;12358;2348;14706
FAC0034713;2015-05-15;CLI00625;FACTURA;2;2;40584;7711;48295
FAC0034714;2015-07-03;CLI00785;FACTURA;34;2;348040;66128;414168
FAC0034715;2015-05-13;CLI00648;FACTURA;13;1;104790;19910;124700
FAC0034716;2015-10-15;CLI00325;FACTURA;15;2;163458;31057;194515
FAC0034717;2015-06-23;CLI00827;FACTURA;10;2;56222;10682;66904
FAC0034718;2015-04-12;CLI00423;FACTURA;25;2;22908;4353;27261
FAC0034719;2015-10-01;CLI00348;FACTURA;18;1;34187;6496;40683
FAC0034720;2015-09-20;CLI00069;FACTURA;12;2;142401;27056;169457
FAC0034721;2015-12-03;CLI00807;FACTURA;7;2;196245;37287;233532
FAC0034722;2015-01-12;CLI00213;FACTURA;24;2;27071;5143;32214
FAC0034723;2015-08-10;CLI00632;FACTURA;42;1;79749;15152;94901
FAC0034724;2015-08-04;CLI00545;FACTURA;22;2;278432;52902;331334
FAC0034725;2015-12-16;CLI00815;FACTURA;36;2;33844;6430;40274
FAC0034726;2015-08-30;CLI00207;FACTURA;29;2;22639;4301;26940
FAC0034727;2015-06-11;CLI00948;FACTURA;36;1;158473;30110;188583
FAC0034728;2015-10-05;CLI00575;FACTURA;6;2;104130;19785;123915
FAC0034729;2015-05-08;CLI00035;FACTURA;15;2;28338;5384;33722
FAC0034730;2015-01-25;CLI00321;FACTURA;17;2;47415;9009;56424
FAC0034731;2015-08-03;CLI00581;FACTURA;19;2;335970;63834;399804
FAC0034732;2015-08-16;CLI00933;FACTURA;47;2;81729;15529;97258
FAC0034733;2015-08-23;CLI00478;FACTURA;36;1;65577;12460;78037
FAC0034734;2015-11-09;CLI00301;FACTURA;29;2;8448;1605;10053
FAC0034735;2015-12-19;CLI00779;FACTURA;28;2;56898;10811;67709
FAC0034736;2015-02-16;CLI00774;FACTURA;39;1;49360;9378;58738
FAC0034737;2015-04-21;CLI00800;FACTURA;19;1;87220;16572;103792
FAC0034738;2015-06-08;CLI00853;FACTURA;49;2;177842;33790;211632
FAC0034739;2015-10-04;CLI00837;FACTURA;12;2;64140;12187;76327
FAC0034740;2015-04-06;CLI00882;FACTURA;16;1;88180;16754;104934
FAC0034741;2015-01-28;CLI00431;FACTURA;9;2;94485;17952;112437
FAC0034742;2015-04-15;CLI00570;FACTURA;12;1;33828;6427;40255
FAC0034743;2015-04-20;CLI00939;FACTURA;45;2;28449;5405;33854
FAC0034744;2015-10-17;CLI00221;FACTURA;39;2;196904;37412;234316
FAC0034745;2015-04-06;CLI00350;FACTURA;3;1;73353;13937;87290
FAC0034746;2015-05-10;CLI00155;FACTURA;39;2;75894;14420;90314
FAC0034747;2015-05-13;CLI00844;FACTURA;39;1;281110;53411;334521
FAC0034748;2015-10-18;CLI00818;FACTURA;33;1;341870;64955;406825
FAC0034749;2015-09-26;CLI00637;FACTURA;14;2;57270;10881;68151
FAC0034750;2015-10-22;CLI00027;FACTURA;18;2;132915;25254;158169
FAC0034751;2015-11-15;CLI00292;FACTURA;17;1;75568;14358;89926
FAC0034752;2015-07-20;CLI00308;FACTURA;38;1;294894;56030;350924
FAC0034753;2015-11-10;CLI00801;FACTURA;7;2;22206;4219;26425
FAC0034754;2015-01-21;CLI00501;FACTURA;37;2;163458;31057;194515
FAC0034755;2015-02-13;CLI00608;FACTURA;34;1;156048;29649;185697
FAC0034756;2015-01-09;CLI00801;FACTURA;42;2;57016;10833;67849
FAC0034757;2015-02-22;CLI00127;FACTURA;26;2;24680;4689;29369
FAC0034758;2015-10-09;CLI00206;FACTURA;16;1;104412;19838;124250
FAC0034759;2015-10-26;CLI00005;FACTURA;17;2;138545;26324;164869
FAC0034760;2015-01-03;CLI00585;FACTURA;4;2;130830;24858;155688
FAC0034761;2015-10-04;CLI00306;FACTURA;1;1;28508;5417;33925
FAC0034762;2015-01-09;CLI00008;FACTURA;39;1;18892;3589;22481
FAC0034763;2015-10-29;CLI00612;FACTURA;19;1;30850;5862;36712
FAC0034764;2015-08-13;CLI00032;FACTURA;4;1;60876;11566;72442
FAC0034765;2015-05-08;CLI00109;FACTURA;19;2;22552;4285;26837
FAC0034766;2015-11-03;CLI00714;FACTURA;13;1;35272;6702;41974
FAC0034767;2015-01-13;CLI00883;FACTURA;14;2;22873;4346;27219
FAC0034768;2015-01-13;CLI00853;FACTURA;50;2;100338;19064;119402
FAC0034769;2015-07-19;CLI00724;FACTURA;16;1;25344;4815;30159
FAC0034770;2015-01-28;CLI00804;FACTURA;44;1;186081;35355;221436
FAC0034771;2015-07-11;CLI00906;FACTURA;14;1;113195;21507;134702
FAC0034772;2015-12-15;CLI00888;FACTURA;14;1;214100;40679;254779
FAC0034773;2015-10-26;CLI00393;FACTURA;5;2;112444;21364;133808
FAC0034774;2015-06-25;CLI00144;FACTURA;42;1;18537;3522;22059
FAC0034775;2015-09-19;CLI00126;FACTURA;12;1;252980;48066;301046
FAC0034776;2015-08-15;CLI00371;FACTURA;9;2;70544;13403;83947
FAC0034777;2015-03-21;CLI00646;FACTURA;12;1;145224;27593;172817
FAC0034778;2015-05-14;CLI00862;FACTURA;19;1;54142;10287;64429
FAC0034779;2015-03-15;CLI00322;FACTURA;23;1;49336;9374;58710
FAC0034780;2015-05-26;CLI00082;FACTURA;48;1;20343;3865;24208
FAC0034781;2015-11-27;CLI00631;FACTURA;43;2;20343;3865;24208
FAC0034782;2015-07-03;CLI00456;FACTURA;34;1;141088;26807;167895
FAC0034783;2015-03-15;CLI00141;FACTURA;43;2;142540;27083;169623
FAC0034784;2015-08-07;CLI00154;FACTURA;13;1;160111;30421;190532
FAC0034785;2015-01-18;CLI00372;FACTURA;20;1;39730;7549;47279
FAC0034786;2015-03-10;CLI00352;FACTURA;12;1;47668;9057;56725
FAC0034787;2015-04-02;CLI00706;FACTURA;44;1;42194;8017;50211
FAC0034788;2015-02-04;CLI00038;FACTURA;48;1;281110;53411;334521
FAC0034789;2015-07-05;CLI00037;FACTURA;41;2;52908;10053;62961
FAC0034790;2015-12-02;CLI00970;FACTURA;6;1;22873;4346;27219
FAC0034791;2015-08-31;CLI00350;FACTURA;24;1;94460;17947;112407
FAC0034792;2015-03-11;CLI00825;FACTURA;41;2;190053;36110;226163
FAC0034793;2015-08-08;CLI00157;FACTURA;2;2;83127;15794;98921
FAC0034794;2015-07-07;CLI00497;FACTURA;48;2;56676;10768;67444
FAC0034795;2015-09-13;CLI00877;FACTURA;4;2;56676;10768;67444
FAC0034796;2015-10-26;CLI00144;FACTURA;16;1;47230;8974;56204
FAC0034797;2015-05-15;CLI00154;FACTURA;3;1;29003;5511;34514
FAC0034798;2015-06-18;CLI00667;FACTURA;40;2;71502;13585;85087
FAC0034799;2015-03-16;CLI00477;FACTURA;21;2;159498;30305;189803
FAC0034800;2015-02-09;CLI00642;FACTURA;37;1;170073;32314;202387
FAC0034801;2015-02-16;CLI00963;FACTURA;10;2;261027;49595;310622
FAC0034802;2015-06-08;CLI00881;FACTURA;27;2;91632;17410;109042
FAC0034803;2015-10-21;CLI00902;FACTURA;2;1;54142;10287;64429
FAC0034804;2015-08-14;CLI00110;FACTURA;9;1;37020;7034;44054
FAC0034805;2015-07-12;CLI00525;FACTURA;46;2;163830;31128;194958
FAC0034806;2015-10-29;CLI00852;FACTURA;47;1;168776;32067;200843
FAC0034807;2015-12-26;CLI00384;FACTURA;20;1;174440;33144;207584
FAC0034808;2015-02-27;CLI00608;FACTURA;35;1;312390;59354;371744
FAC0034809;2015-07-15;CLI00616;FACTURA;8;1;147819;28086;175905
FAC0034810;2015-10-31;CLI00194;FACTURA;49;1;147679;28059;175738
FAC0034811;2015-12-14;CLI00700;FACTURA;35;1;75588;14362;89950
FAC0034812;2015-08-21;CLI00249;FACTURA;46;2;203784;38719;242503
FAC0034813;2015-06-10;CLI00133;FACTURA;17;2;228730;43459;272189
FAC0034814;2015-05-02;CLI00467;FACTURA;22;2;183087;34787;217874
FAC0034815;2015-08-24;CLI00975;FACTURA;31;2;216568;41148;257716
FAC0034816;2015-09-08;CLI00545;FACTURA;38;2;199854;37972;237826
FAC0034817;2015-12-11;CLI00638;FACTURA;33;1;117036;22237;139273
FAC0034818;2015-03-25;CLI00816;FACTURA;44;1;50596;9613;60209
FAC0034819;2015-10-18;CLI00185;FACTURA;27;2;161176;30623;191799
FAC0034820;2015-11-22;CLI00112;FACTURA;4;1;39466;7499;46965
FAC0034821;2015-11-01;CLI00725;FACTURA;44;2;29003;5511;34514
FAC0034822;2015-11-06;CLI00824;FACTURA;43;1;25406;4827;30233
FAC0034823;2015-07-13;CLI00521;FACTURA;21;2;56676;10768;67444
FAC0034824;2015-01-23;CLI00241;FACTURA;2;2;54696;10392;65088
FAC0034825;2015-12-16;CLI00010;FACTURA;22;1;35751;6793;42544
FAC0034826;2015-03-12;CLI00810;FACTURA;24;1;60441;11484;71925
FAC0034827;2015-03-05;CLI00957;FACTURA;28;2;47668;9057;56725
FAC0034828;2015-10-03;CLI00908;FACTURA;35;1;27243;5176;32419
FAC0034829;2015-02-05;CLI00082;FACTURA;12;1;224888;42729;267617
FAC0034830;2015-02-09;CLI00894;FACTURA;12;1;23834;4528;28362
FAC0034831;2015-09-30;CLI00245;FACTURA;6;2;171280;32543;203823
FAC0034832;2015-10-05;CLI00250;FACTURA;7;1;145015;27553;172568
FAC0034833;2015-06-21;CLI00182;FACTURA;40;1;228064;43332;271396
FAC0034834;2015-12-30;CLI00471;FACTURA;20;2;50766;9646;60412
FAC0034835;2015-06-06;CLI00412;FACTURA;25;1;285080;54165;339245
FAC0034836;2015-08-01;CLI00210;FACTURA;7;1;243628;46289;289917
FAC0034837;2015-11-21;CLI00001;FACTURA;6;2;252980;48066;301046
FAC0034838;2015-11-16;CLI00023;FACTURA;33;2;16035;3047;19082
FAC0034839;2015-09-02;CLI00773;FACTURA;3;2;341870;64955;406825
FAC0034840;2015-12-14;CLI00003;FACTURA;26;2;50812;9654;60466
FAC0034841;2015-09-07;CLI00670;FACTURA;23;1;21117;4012;25129
FAC0034842;2015-04-29;CLI00535;FACTURA;25;2;203430;38652;242082
FAC0034843;2015-04-29;CLI00367;FACTURA;24;2;91314;17350;108664
FAC0034844;2015-10-07;CLI00811;FACTURA;28;2;42194;8017;50211
FAC0034845;2015-09-28;CLI00706;FACTURA;10;1;23834;4528;28362
FAC0034846;2015-11-25;CLI00494;FACTURA;20;1;76032;14446;90478
FAC0034847;2015-06-13;CLI00853;FACTURA;36;2;203751;38713;242464
FAC0034848;2015-11-22;CLI00884;FACTURA;15;1;98672;18748;117420
FAC0034849;2015-05-10;CLI00321;FACTURA;44;2;174020;33064;207084
FAC0034850;2015-10-06;CLI00434;FACTURA;23;1;64544;12263;76807
FAC0034851;2015-10-06;CLI00490;FACTURA;4;1;138840;26380;165220
FAC0034852;2015-04-03;CLI00160;FACTURA;29;1;85524;16250;101774
FAC0034853;2015-06-26;CLI00865;FACTURA;29;2;341870;64955;406825
FAC0034854;2015-09-15;CLI00712;FACTURA;38;1;40584;7711;48295
FAC0034855;2015-07-19;CLI00652;FACTURA;7;1;142401;27056;169457
FAC0034856;2015-11-30;CLI00681;FACTURA;8;2;149870;28475;178345
FAC0034857;2015-07-01;CLI00783;FACTURA;43;2;246130;46765;292895
FAC0034858;2015-11-15;CLI00392;FACTURA;41;1;277680;52759;330439
FAC0034859;2015-09-19;CLI00137;FACTURA;41;2;203751;38713;242464
FAC0034860;2015-11-29;CLI00039;FACTURA;3;2;216568;41148;257716
FAC0034861;2015-07-23;CLI00497;FACTURA;9;2;196596;37353;233949
FAC0034862;2015-06-14;CLI00948;FACTURA;32;1;110836;21059;131895
FAC0034863;2015-08-17;CLI00783;FACTURA;33;2;28508;5417;33925
FAC0034864;2015-03-03;CLI00310;FACTURA;29;1;222012;42182;264194
FAC0034865;2015-08-04;CLI00548;FACTURA;1;1;256572;48749;305321
FAC0034866;2015-08-27;CLI00145;FACTURA;39;2;118454;22506;140960
FAC0034867;2015-10-15;CLI00651;FACTURA;45;2;112952;21461;134413
FAC0034868;2015-03-09;CLI00744;FACTURA;33;1;148008;28122;176130
FAC0034869;2015-05-31;CLI00399;FACTURA;40;2;129088;24527;153615
FAC0034870;2015-07-09;CLI00559;FACTURA;4;2;177648;33753;211401
FAC0034871;2015-03-17;CLI00060;FACTURA;33;1;138840;26380;165220
FAC0034872;2015-01-09;CLI00858;FACTURA;34;1;33844;6430;40274
FAC0034873;2015-08-21;CLI00919;FACTURA;2;2;245187;46586;291773
FAC0034874;2015-02-10;CLI00684;FACTURA;5;1;66618;12657;79275
FAC0034875;2015-01-05;CLI00844;FACTURA;15;1;181112;34411;215523
FAC0034876;2015-11-14;CLI00709;FACTURA;46;2;50946;9680;60626
FAC0034877;2015-12-24;CLI00400;FACTURA;46;1;126582;24051;150633
FAC0034878;2015-05-28;CLI00718;FACTURA;2;1;217944;41409;259353
FAC0034879;2015-10-20;CLI00973;FACTURA;45;2;54486;10352;64838
FAC0034880;2015-07-04;CLI00653;FACTURA;29;2;256572;48749;305321
FAC0034881;2015-06-02;CLI00990;FACTURA;29;1;122058;23191;145249
FAC0034882;2015-10-01;CLI00227;FACTURA;30;2;28190;5356;33546
FAC0034883;2015-07-19;CLI00679;FACTURA;2;2;138545;26324;164869
FAC0034884;2015-02-25;CLI00569;FACTURA;20;2;136740;25981;162721
FAC0034885;2015-08-01;CLI00477;FACTURA;47;2;35272;6702;41974
FAC0034886;2015-11-21;CLI00364;FACTURA;32;1;64140;12187;76327
FAC0034887;2015-06-24;CLI00842;FACTURA;39;1;79749;15152;94901
FAC0034888;2015-03-20;CLI00122;FACTURA;9;1;45104;8570;53674
FAC0034889;2015-10-05;CLI00559;FACTURA;31;2;163458;31057;194515
FAC0034890;2015-01-06;CLI00222;FACTURA;5;1;129006;24511;153517
FAC0034891;2015-04-06;CLI00698;FACTURA;47;1;112952;21461;134413
FAC0034892;2015-04-20;CLI00353;FACTURA;48;2;181112;34411;215523
FAC0034893;2015-08-12;CLI00669;FACTURA;14;2;159498;30305;189803
FAC0034894;2015-07-30;CLI00398;FACTURA;33;1;80178;15234;95412
FAC0034895;2015-12-23;CLI00708;FACTURA;5;1;39730;7549;47279
FAC0034896;2015-04-06;CLI00099;FACTURA;25;2;138840;26380;165220
FAC0034897;2015-09-27;CLI00871;FACTURA;40;2;27709;5265;32974
FAC0034898;2015-03-04;CLI00900;FACTURA;21;1;174440;33144;207584
FAC0034899;2015-11-27;CLI00226;FACTURA;47;1;30895;5870;36765
FAC0034900;2015-08-19;CLI00552;FACTURA;8;1;189873;36076;225949
FAC0034901;2015-01-19;CLI00254;FACTURA;22;1;82044;15588;97632
FAC0034902;2015-07-04;CLI00993;FACTURA;39;2;163830;31128;194958
FAC0034903;2015-11-17;CLI00376;FACTURA;44;1;49360;9378;58738
FAC0034904;2015-08-27;CLI00412;FACTURA;14;1;239309;45469;284778
FAC0034905;2015-12-22;CLI00592;FACTURA;33;1;28111;5341;33452
FAC0034906;2015-07-25;CLI00864;FACTURA;17;1;161360;30658;192018
FAC0034907;2015-03-30;CLI00527;FACTURA;45;2;63291;12025;75316
FAC0034908;2015-10-18;CLI00890;FACTURA;5;1;196245;37287;233532
FAC0034909;2015-06-28;CLI00298;FACTURA;6;1;24668;4687;29355
FAC0034910;2015-03-10;CLI00020;FACTURA;2;1;208260;39569;247829
FAC0034911;2015-07-03;CLI00629;FACTURA;34;2;205857;39113;244970
FAC0034912;2015-01-19;CLI00174;FACTURA;28;1;245187;46586;291773
FAC0034913;2015-02-12;CLI00755;FACTURA;7;2;80175;15233;95408
FAC0034914;2015-05-26;CLI00213;FACTURA;21;2;44412;8438;52850
FAC0034915;2015-11-30;CLI00971;FACTURA;23;2;117036;22237;139273
FAC0034916;2015-06-21;CLI00765;FACTURA;1;2;174018;33063;207081
FAC0034917;2015-09-23;CLI00012;FACTURA;26;1;112245;21327;133572
FAC0034918;2015-06-16;CLI00939;FACTURA;7;2;86004;16341;102345
FAC0034919;2015-03-23;CLI00109;FACTURA;19;2;153013;29072;182085
FAC0034920;2015-09-28;CLI00275;FACTURA;15;2;129006;24511;153517
FAC0034921;2015-09-19;CLI00042;FACTURA;11;1;67584;12841;80425
FAC0034922;2015-08-15;CLI00818;FACTURA;16;1;174440;33144;207584
FAC0034923;2015-02-26;CLI00788;FACTURA;41;1;104130;19785;123915
FAC0034924;2015-12-28;CLI00615;FACTURA;47;2;113195;21507;134702
FAC0034925;2015-12-10;CLI00511;FACTURA;18;2;67917;12904;80821
FAC0034926;2015-03-22;CLI00770;FACTURA;37;1;249381;47382;296763
FAC0034927;2015-08-19;CLI00551;FACTURA;36;2;56676;10768;67444
FAC0034928;2015-03-19;CLI00359;FACTURA;22;2;104790;19910;124700
FAC0034929;2015-11-26;CLI00388;FACTURA;47;1;67584;12841;80425
FAC0034930;2015-03-02;CLI00927;FACTURA;35;2;104412;19838;124250
FAC0034931;2015-04-30;CLI00251;FACTURA;45;2;95336;18114;113450
FAC0034932;2015-10-13;CLI00173;FACTURA;34;2;52395;9955;62350
FAC0034933;2015-07-30;CLI00351;FACTURA;37;2;196904;37412;234316
FAC0034934;2015-07-21;CLI00016;FACTURA;22;1;171280;32543;203823
FAC0034935;2015-12-14;CLI00222;FACTURA;39;1;75568;14358;89926
FAC0034936;2015-04-04;CLI00270;FACTURA;38;1;32070;6093;38163
FAC0034937;2015-11-24;CLI00853;FACTURA;50;2;45816;8705;54521
FAC0034938;2015-07-03;CLI00502;FACTURA;49;1;22206;4219;26425
FAC0034939;2015-06-09;CLI00886;FACTURA;27;1;80178;15234;95412
FAC0034940;2015-02-05;CLI00736;FACTURA;2;1;57336;10894;68230
FAC0034941;2015-02-11;CLI00198;FACTURA;21;1;252999;48070;301069
FAC0034942;2015-11-07;CLI00359;FACTURA;12;2;95336;18114;113450
FAC0034943;2015-02-10;CLI00669;FACTURA;12;2;110836;21059;131895
FAC0034944;2015-09-14;CLI00213;FACTURA;29;2;23838;4529;28367
FAC0034945;2015-03-18;CLI00538;FACTURA;32;1;55418;10529;65947
FAC0034946;2015-08-03;CLI00762;FACTURA;14;1;47676;9058;56734
FAC0034947;2015-06-05;CLI00201;FACTURA;33;2;33844;6430;40274
FAC0034948;2015-03-01;CLI00666;FACTURA;33;1;54142;10287;64429
FAC0034949;2015-09-18;CLI00312;FACTURA;7;1;196596;37353;233949
FAC0034950;2015-09-16;CLI00328;FACTURA;21;1;16922;3215;20137
FAC0034951;2015-02-23;CLI00822;FACTURA;36;1;245187;46586;291773
FAC0034952;2015-12-24;CLI00103;FACTURA;29;2;94485;17952;112437
FAC0034953;2015-03-16;CLI00555;FACTURA;16;2;20147;3828;23975
FAC0034954;2015-03-30;CLI00961;FACTURA;23;2;24680;4689;29369
FAC0034955;2015-12-17;CLI00432;FACTURA;32;1;61700;11723;73423
FAC0034956;2015-07-09;CLI00493;FACTURA;41;2;24668;4687;29355
FAC0034957;2015-09-01;CLI00297;FACTURA;44;2;109392;20784;130176
FAC0034958;2015-03-07;CLI00254;FACTURA;10;1;85014;16153;101167
FAC0034959;2015-09-12;CLI00319;FACTURA;36;2;217944;41409;259353
FAC0034960;2015-09-10;CLI00409;FACTURA;19;2;56380;10712;67092
FAC0034961;2015-03-28;CLI00760;FACTURA;4;1;57270;10881;68151
FAC0034962;2015-07-21;CLI00590;FACTURA;21;1;277090;52647;329737
FAC0034963;2015-12-17;CLI00906;FACTURA;41;1;222060;42191;264251
FAC0034964;2015-08-08;CLI00554;FACTURA;27;1;114032;21666;135698
FAC0034965;2015-06-16;CLI00525;FACTURA;3;2;149870;28475;178345
FAC0034966;2015-08-30;CLI00848;FACTURA;3;1;34804;6613;41417
FAC0034967;2015-01-14;CLI00062;FACTURA;23;1;312390;59354;371744
FAC0034968;2015-02-24;CLI00015;FACTURA;28;2;45104;8570;53674
FAC0034969;2015-11-26;CLI00534;FACTURA;30;1;6179;1174;7353
FAC0034970;2015-05-16;CLI00376;FACTURA;23;1;6170;1172;7342
FAC0034971;2015-02-23;CLI00875;FACTURA;18;2;5638;1071;6709
FAC0034972;2015-11-24;CLI00147;FACTURA;5;2;130830;24858;155688
FAC0034973;2015-07-19;CLI00995;FACTURA;30;2;201582;38301;239883
FAC0034974;2015-09-28;CLI00917;FACTURA;1;2;84480;16051;100531
FAC0034975;2015-07-15;CLI00890;FACTURA;47;1;49336;9374;58710
FAC0034976;2015-06-04;CLI00979;FACTURA;13;2;285080;54165;339245
FAC0034977;2015-04-26;CLI00088;FACTURA;4;1;108972;20705;129677
FAC0034978;2015-09-18;CLI00725;FACTURA;38;2;105816;20105;125921
FAC0034979;2015-03-25;CLI00081;FACTURA;46;2;242970;46164;289134
FAC0034980;2015-05-15;CLI00297;FACTURA;40;2;161176;30623;191799
FAC0034981;2015-11-29;CLI00434;FACTURA;15;1;30603;5815;36418
FAC0034982;2015-05-18;CLI00017;FACTURA;25;2;196245;37287;233532
FAC0034983;2015-03-28;CLI00492;FACTURA;39;1;312390;59354;371744
FAC0034984;2015-08-04;CLI00747;FACTURA;26;2;111030;21096;132126
FAC0034985;2015-11-27;CLI00270;FACTURA;14;1;131064;24902;155966
FAC0034986;2015-10-28;CLI00729;FACTURA;29;2;102010;19382;121392
FAC0034987;2015-07-06;CLI00112;FACTURA;34;1;28111;5341;33452
FAC0034988;2015-02-11;CLI00205;FACTURA;39;2;30850;5862;36712
FAC0034989;2015-02-12;CLI00199;FACTURA;13;2;54696;10392;65088
FAC0034990;2015-11-16;CLI00221;FACTURA;8;2;37932;7207;45139
FAC0034991;2015-05-20;CLI00206;FACTURA;31;1;140555;26705;167260
FAC0034992;2015-05-04;CLI00330;FACTURA;2;1;45816;8705;54521
FAC0034993;2015-11-27;CLI00562;FACTURA;39;1;26583;5051;31634
FAC0034994;2015-01-11;CLI00923;FACTURA;15;2;76218;14481;90699
FAC0034995;2015-05-01;CLI00613;FACTURA;42;2;71514;13588;85102
FAC0034996;2015-03-22;CLI00609;FACTURA;35;2;196904;37412;234316
FAC0034997;2015-05-29;CLI00869;FACTURA;42;2;27709;5265;32974
FAC0034998;2015-03-28;CLI00379;FACTURA;49;2;196904;37412;234316
FAC0034999;2015-01-13;CLI00610;FACTURA;4;1;98298;18677;116975
FAC0035000;2015-11-28;CLI00302;FACTURA;12;1;67917;12904;80821
FAC0035001;2015-09-16;CLI00363;FACTURA;32;2;252980;48066;301046
FAC0035002;2015-08-28;CLI00535;FACTURA;13;2;63291;12025;75316
FAC0035003;2015-06-11;CLI00517;FACTURA;32;2;182984;34767;217751
FAC0035004;2015-03-26;CLI00027;FACTURA;35;2;188970;35904;224874
FAC0035005;2015-06-29;CLI00128;FACTURA;45;1;81372;15461;96833
FAC0035006;2015-12-28;CLI00587;FACTURA;26;2;14334;2723;17057
FAC0035007;2015-09-11;CLI00114;FACTURA;13;1;181112;34411;215523
FAC0035008;2015-04-16;CLI00687;FACTURA;29;2;80680;15329;96009
FAC0035009;2015-02-14;CLI00840;FACTURA;4;1;31784;6039;37823
FAC0035010;2015-06-25;CLI00238;FACTURA;16;1;133236;25315;158551
FAC0035011;2015-03-08;CLI00866;FACTURA;43;1;100735;19140;119875
FAC0035012;2015-06-05;CLI00465;FACTURA;41;2;29003;5511;34514
FAC0035013;2015-04-08;CLI00885;FACTURA;42;2;136215;25881;162096
FAC0035014;2015-02-07;CLI00570;FACTURA;23;1;68724;13058;81782
FAC0035015;2015-07-03;CLI00793;FACTURA;15;2;64544;12263;76807
FAC0035016;2015-11-25;CLI00769;FACTURA;41;2;110836;21059;131895
FAC0035017;2015-07-07;CLI00341;FACTURA;9;2;75864;14414;90278
FAC0035018;2015-01-08;CLI00239;FACTURA;26;2;105585;20061;125646
FAC0035019;2015-03-02;CLI00131;FACTURA;1;2;196596;37353;233949
FAC0035020;2015-10-23;CLI00965;FACTURA;7;2;71022;13494;84516
FAC0035021;2015-09-02;CLI00582;FACTURA;1;1;137238;26075;163313
FAC0035022;2015-08-18;CLI00589;FACTURA;10;2;39012;7412;46424
FAC0035023;2015-06-07;CLI00075;FACTURA;46;2;224888;42729;267617
FAC0035024;2015-09-27;CLI00602;FACTURA;31;1;143340;27235;170575
FAC0035025;2015-05-02;CLI00976;FACTURA;21;1;101460;19277;120737
FAC0035026;2015-05-21;CLI00983;FACTURA;32;2;108972;20705;129677
FAC0035027;2015-07-13;CLI00174;FACTURA;11;1;22908;4353;27261
FAC0035028;2015-09-22;CLI00613;FACTURA;39;2;132279;25133;157412
FAC0035029;2015-01-19;CLI00421;FACTURA;40;2;85524;16250;101774
FAC0035030;2015-06-30;CLI00294;FACTURA;2;1;66381;12612;78993
FAC0035031;2015-11-14;CLI00010;FACTURA;16;1;167985;31917;199902
FAC0035032;2015-05-12;CLI00347;FACTURA;33;2;152635;29001;181636
FAC0035033;2015-06-23;CLI00332;FACTURA;6;1;127365;24199;151564
FAC0035034;2015-01-27;CLI00094;FACTURA;26;1;205122;38973;244095
FAC0035035;2015-01-06;CLI00053;FACTURA;22;2;33597;6383;39980
FAC0035036;2015-06-16;CLI00978;FACTURA;19;1;175554;33355;208909
FAC0035037;2015-02-19;CLI00346;FACTURA;25;1;307683;58460;366143
FAC0035038;2015-01-22;CLI00667;FACTURA;23;2;56676;10768;67444
FAC0035039;2015-09-11;CLI00808;FACTURA;6;1;65532;12451;77983
FAC0035040;2015-11-23;CLI00989;FACTURA;15;2;16896;3210;20106
FAC0035041;2015-04-27;CLI00116;FACTURA;25;1;97530;18531;116061
FAC0035042;2015-11-10;CLI00126;FACTURA;33;1;108972;20705;129677
FAC0035043;2015-09-29;CLI00264;FACTURA;18;1;47230;8974;56204
FAC0035044;2015-09-30;CLI00611;FACTURA;38;2;212664;40406;253070
FAC0035045;2015-09-06;CLI00781;FACTURA;26;2;40686;7730;48416
FAC0035046;2015-05-26;CLI00434;FACTURA;45;1;28508;5417;33925
FAC0035047;2015-05-01;CLI00070;FACTURA;25;1;32272;6132;38404
FAC0035048;2015-05-05;CLI00481;FACTURA;9;2;55530;10551;66081
FAC0035049;2015-01-02;CLI00054;FACTURA;38;1;270710;51435;322145
FAC0035050;2015-05-11;CLI00669;FACTURA;13;2;249381;47382;296763
FAC0035051;2015-05-20;CLI00222;FACTURA;12;1;16922;3215;20137
FAC0035052;2015-01-03;CLI00543;FACTURA;27;2;67194;12767;79961
FAC0035053;2015-07-14;CLI00446;FACTURA;23;1;312390;59354;371744
FAC0035054;2015-06-02;CLI00632;FACTURA;3;1;166254;31588;197842
FAC0035055;2015-05-24;CLI00862;FACTURA;3;1;272430;51762;324192
FAC0035056;2015-03-10;CLI00106;FACTURA;31;1;96210;18280;114490
FAC0035057;2015-10-03;CLI00127;FACTURA;50;2;335970;63834;399804
FAC0035058;2015-12-21;CLI00564;FACTURA;20;1;61029;11596;72625
FAC0035059;2015-08-09;CLI00286;FACTURA;42;1;30603;5815;36418
FAC0035060;2015-11-10;CLI00160;FACTURA;49;1;22206;4219;26425
FAC0035061;2015-04-20;CLI00051;FACTURA;31;2;228654;43444;272098
FAC0035062;2015-02-26;CLI00634;FACTURA;9;1;147819;28086;175905
FAC0035063;2015-09-06;CLI00037;FACTURA;44;2;126582;24051;150633
FAC0035064;2015-06-01;CLI00190;FACTURA;38;1;37932;7207;45139
FAC0035065;2015-02-24;CLI00684;FACTURA;47;1;168666;32047;200713
FAC0035066;2015-01-27;CLI00854;FACTURA;20;1;83832;15928;99760
FAC0035067;2015-09-12;CLI00619;FACTURA;36;2;239247;45457;284704
FAC0035068;2015-05-26;CLI00371;FACTURA;36;2;75588;14362;89950
FAC0035069;2015-01-07;CLI00533;FACTURA;27;2;94830;18018;112848
FAC0035070;2015-09-06;CLI00240;FACTURA;49;1;25298;4807;30105
FAC0035071;2015-09-08;CLI00679;FACTURA;5;2;221517;42088;263605
FAC0035072;2015-10-15;CLI00597;FACTURA;23;2;217944;41409;259353
FAC0035073;2015-11-02;CLI00214;FACTURA;33;1;199556;37916;237472
FAC0035074;2015-11-30;CLI00473;FACTURA;37;2;239247;45457;284704
FAC0035075;2015-04-25;CLI00825;FACTURA;10;2;254060;48271;302331
FAC0035076;2015-04-30;CLI00067;FACTURA;48;2;10201;1938;12139
FAC0035077;2015-10-06;CLI00142;FACTURA;4;1;156048;29649;185697
FAC0035078;2015-09-09;CLI00965;FACTURA;1;2;94485;17952;112437
FAC0035079;2015-09-11;CLI00339;FACTURA;29;2;216568;41148;257716
FAC0035080;2015-09-14;CLI00447;FACTURA;12;2;174018;33063;207081
FAC0035081;2015-09-11;CLI00144;FACTURA;32;1;26583;5051;31634
FAC0035082;2015-12-28;CLI00400;FACTURA;1;1;256572;48749;305321
FAC0035083;2015-12-29;CLI00939;FACTURA;32;2;126490;24033;150523
FAC0035084;2015-02-20;CLI00587;FACTURA;10;2;132279;25133;157412
FAC0035085;2015-07-14;CLI00178;FACTURA;18;1;68370;12990;81360
FAC0035086;2015-02-15;CLI00145;FACTURA;48;2;71407;13567;84974
FAC0035087;2015-05-18;CLI00508;FACTURA;18;1;80175;15233;95408
FAC0035088;2015-11-04;CLI00089;FACTURA;18;2;135834;25808;161642
FAC0035089;2015-12-10;CLI00869;FACTURA;45;2;21097;4008;25105
FAC0035090;2015-05-31;CLI00191;FACTURA;41;2;86004;16341;102345
FAC0035091;2015-06-04;CLI00351;FACTURA;1;2;156048;29649;185697
FAC0035092;2015-06-08;CLI00868;FACTURA;16;1;27348;5196;32544
FAC0035093;2015-03-26;CLI00041;FACTURA;8;2;91314;17350;108664
FAC0035094;2015-10-24;CLI00160;FACTURA;21;1;186081;35355;221436
FAC0035095;2015-03-04;CLI00400;FACTURA;47;1;170073;32314;202387
FAC0035096;2015-04-13;CLI00987;FACTURA;12;2;55418;10529;65947
FAC0035097;2015-01-14;CLI00718;FACTURA;4;1;229257;43559;272816
FAC0035098;2015-05-05;CLI00238;FACTURA;46;1;73353;13937;87290
FAC0035099;2015-06-16;CLI00916;FACTURA;26;1;307683;58460;366143
FAC0035100;2015-04-13;CLI00594;FACTURA;18;1;63291;12025;75316
FAC0035101;2015-04-12;CLI00848;FACTURA;32;1;57336;10894;68230
FAC0035102;2015-11-15;CLI00437;FACTURA;27;2;28449;5405;33854
FAC0035103;2015-12-08;CLI00924;FACTURA;7;1;245187;46586;291773
FAC0035104;2015-05-23;CLI00771;FACTURA;32;2;39012;7412;46424
FAC0035105;2015-04-09;CLI00405;FACTURA;41;2;56691;10771;67462
FAC0035106;2015-05-09;CLI00805;FACTURA;34;2;142401;27056;169457
FAC0035107;2015-07-22;CLI00283;FACTURA;17;2;84388;16034;100422
FAC0035108;2015-01-09;CLI00395;FACTURA;16;2;170073;32314;202387
FAC0035109;2015-12-04;CLI00166;FACTURA;18;1;21410;4068;25478
FAC0035110;2015-03-29;CLI00475;FACTURA;37;2;40294;7656;47950
FAC0035111;2015-05-22;CLI00667;FACTURA;17;2;28449;5405;33854
FAC0035112;2015-04-11;CLI00569;FACTURA;19;2;130830;24858;155688
FAC0035113;2015-11-14;CLI00312;FACTURA;30;1;42240;8026;50266
FAC0035114;2015-07-22;CLI00703;FACTURA;25;2;84480;16051;100531
FAC0035115;2015-07-19;CLI00956;FACTURA;20;1;101715;19326;121041
FAC0035116;2015-12-02;CLI00560;FACTURA;37;1;60441;11484;71925
FAC0035117;2015-05-06;CLI00219;FACTURA;25;2;52908;10053;62961
FAC0035118;2015-09-15;CLI00135;FACTURA;21;2;163458;31057;194515
FAC0035119;2015-10-03;CLI00742;FACTURA;19;1;75588;14362;89950
FAC0035120;2015-09-04;CLI00880;FACTURA;49;1;34804;6613;41417
FAC0035121;2015-02-26;CLI00983;FACTURA;32;2;82044;15588;97632
FAC0035122;2015-02-06;CLI00021;FACTURA;20;2;47230;8974;56204
FAC0035123;2015-12-04;CLI00690;FACTURA;25;1;68370;12990;81360
FAC0035124;2015-12-12;CLI00734;FACTURA;33;1;65577;12460;78037
FAC0035125;2015-12-24;CLI00400;FACTURA;24;1;80588;15312;95900
FAC0035126;2015-03-19;CLI00462;FACTURA;48;1;57016;10833;67849
FAC0035127;2015-08-15;CLI00129;FACTURA;33;2;79460;15097;94557
FAC0035128;2015-05-30;CLI00081;FACTURA;37;2;254060;48271;302331
FAC0035129;2015-12-05;CLI00003;FACTURA;22;2;218050;41430;259480
FAC0035130;2015-03-28;CLI00160;FACTURA;16;1;73353;13937;87290
FAC0035131;2015-08-06;CLI00594;FACTURA;14;1;136542;25943;162485
FAC0035132;2015-07-20;CLI00586;FACTURA;39;1;22206;4219;26425
FAC0035133;2015-05-31;CLI00108;FACTURA;45;1;68619;13038;81657
FAC0035134;2015-03-25;CLI00380;FACTURA;34;1;28190;5356;33546
FAC0035135;2015-10-25;CLI00966;FACTURA;50;1;39012;7412;46424
FAC0035136;2015-01-23;CLI00110;FACTURA;45;1;27709;5265;32974
FAC0035137;2015-01-03;CLI00306;FACTURA;20;1;174020;33064;207084
FAC0035138;2015-12-26;CLI00426;FACTURA;33;1;18892;3589;22481
FAC0035139;2015-04-04;CLI00083;FACTURA;33;2;8448;1605;10053
FAC0035140;2015-07-14;CLI00738;FACTURA;17;1;57336;10894;68230
FAC0035141;2015-12-14;CLI00407;FACTURA;14;2;100735;19140;119875
FAC0035142;2015-10-20;CLI00453;FACTURA;4;2;71407;13567;84974
FAC0035143;2015-05-23;CLI00981;FACTURA;44;2;22873;4346;27219
FAC0035144;2015-09-30;CLI00785;FACTURA;44;2;63351;12037;75388
FAC0035145;2015-06-09;CLI00403;FACTURA;50;2;28190;5356;33546
FAC0035146;2015-08-12;CLI00760;FACTURA;42;1;32070;6093;38163
FAC0035147;2015-12-13;CLI00754;FACTURA;25;1;158473;30110;188583
FAC0035148;2015-04-17;CLI00316;FACTURA;31;1;123340;23435;146775
FAC0035149;2015-04-06;CLI00330;FACTURA;46;1;153013;29072;182085
FAC0035150;2015-08-12;CLI00650;FACTURA;34;1;16136;3066;19202
FAC0035151;2015-02-04;CLI00443;FACTURA;9;2;37074;7044;44118
FAC0035152;2015-07-30;CLI00568;FACTURA;46;1;136748;25982;162730
FAC0035153;2015-05-17;CLI00317;FACTURA;38;2;112952;21461;134413
FAC0035154;2015-09-15;CLI00492;FACTURA;10;1;81372;15461;96833
FAC0035155;2015-08-10;CLI00364;FACTURA;47;1;265830;50508;316338
FAC0035156;2015-11-05;CLI00843;FACTURA;6;2;64230;12204;76434
FAC0035157;2015-07-12;CLI00099;FACTURA;9;2;59136;11236;70372
FAC0035158;2015-11-05;CLI00995;FACTURA;2;2;218050;41430;259480
FAC0035159;2015-10-09;CLI00296;FACTURA;10;1;34187;6496;40683
FAC0035160;2015-09-23;CLI00538;FACTURA;40;1;39466;7499;46965
FAC0035161;2015-03-12;CLI00133;FACTURA;26;2;227682;43260;270942
FAC0035162;2015-12-19;CLI00743;FACTURA;29;2;26583;5051;31634
FAC0035163;2015-10-13;CLI00643;FACTURA;50;2;32070;6093;38163
FAC0035164;2015-12-24;CLI00068;FACTURA;16;1;177842;33790;211632
FAC0035165;2015-05-17;CLI00871;FACTURA;35;2;28190;5356;33546
FAC0035166;2015-01-12;CLI00014;FACTURA;46;1;18966;3604;22570
FAC0035167;2015-10-18;CLI00651;FACTURA;32;2;252980;48066;301046
FAC0035168;2015-11-17;CLI00300;FACTURA;11;1;9483;1802;11285
FAC0035169;2015-02-09;CLI00619;FACTURA;35;2;196777;37388;234165
FAC0035170;2015-07-18;CLI00653;FACTURA;18;2;114540;21763;136303
FAC0035171;2015-12-15;CLI00931;FACTURA;21;2;56380;10712;67092
FAC0035172;2015-11-27;CLI00349;FACTURA;27;2;11454;2176;13630
FAC0035173;2015-03-12;CLI00334;FACTURA;28;1;152436;28963;181399
FAC0035174;2015-07-24;CLI00854;FACTURA;15;1;302373;57451;359824
FAC0035175;2015-05-01;CLI00290;FACTURA;24;1;37932;7207;45139
FAC0035176;2015-10-05;CLI00223;FACTURA;36;2;91314;17350;108664
FAC0035177;2015-01-05;CLI00821;FACTURA;12;2;149870;28475;178345
FAC0035178;2015-03-28;CLI00097;FACTURA;38;2;76032;14446;90478
FAC0035179;2015-01-02;CLI00265;FACTURA;41;2;25344;4815;30159
FAC0035180;2015-01-15;CLI00927;FACTURA;34;2;243639;46291;289930
FAC0035181;2015-12-20;CLI00758;FACTURA;14;1;30603;5815;36418
FAC0035182;2015-11-25;CLI00977;FACTURA;37;2;243639;46291;289930
FAC0035183;2015-07-27;CLI00151;FACTURA;12;2;83832;15928;99760
FAC0035184;2015-06-05;CLI00607;FACTURA;3;2;64544;12263;76807
FAC0035185;2015-10-03;CLI00076;FACTURA;6;1;39730;7549;47279
FAC0035186;2015-03-14;CLI00171;FACTURA;27;2;5638;1071;6709
FAC0035187;2015-08-10;CLI00300;FACTURA;40;1;84333;16023;100356
FAC0035188;2015-10-08;CLI00274;FACTURA;8;1;186081;35355;221436
FAC0035189;2015-05-16;CLI00848;FACTURA;11;1;47668;9057;56725
FAC0035190;2015-10-24;CLI00454;FACTURA;42;1;9446;1795;11241
FAC0035191;2015-12-12;CLI00569;FACTURA;47;2;113195;21507;134702
FAC0035192;2015-12-18;CLI00166;FACTURA;50;1;67917;12904;80821
FAC0035193;2015-05-22;CLI00817;FACTURA;3;2;27243;5176;32419
FAC0035194;2015-12-18;CLI00087;FACTURA;27;2;116012;22042;138054
FAC0035195;2015-12-16;CLI00845;FACTURA;40;2;127030;24136;151166
FAC0035196;2015-04-26;CLI00921;FACTURA;28;2;75894;14420;90314
FAC0035197;2015-01-05;CLI00440;FACTURA;40;1;28508;5417;33925
FAC0035198;2015-11-01;CLI00816;FACTURA;47;1;170935;32478;203413
FAC0035199;2015-05-05;CLI00197;FACTURA;15;2;24668;4687;29355
FAC0035200;2015-12-07;CLI00526;FACTURA;50;1;171048;32499;203547
FAC0035201;2015-09-25;CLI00697;FACTURA;33;2;71670;13617;85287
FAC0035202;2015-05-14;CLI00063;FACTURA;6;2;28338;5384;33722
FAC0035203;2015-08-22;CLI00361;FACTURA;7;2;109295;20766;130061
FAC0035204;2015-02-04;CLI00082;FACTURA;6;1;59585;11321;70906
FAC0035205;2015-11-24;CLI00450;FACTURA;48;1;112952;21461;134413
FAC0035206;2015-08-09;CLI00231;FACTURA;1;2;126490;24033;150523
FAC0035207;2015-11-10;CLI00554;FACTURA;23;1;173550;32975;206525
FAC0035208;2015-12-26;CLI00086;FACTURA;12;1;67194;12767;79961
FAC0035209;2015-08-20;CLI00205;FACTURA;38;2;144315;27420;171735
FAC0035210;2015-08-26;CLI00573;FACTURA;20;2;173550;32975;206525
FAC0035211;2015-11-25;CLI00468;FACTURA;21;1;87220;16572;103792
FAC0035212;2015-02-21;CLI00918;FACTURA;16;1;64230;12204;76434
FAC0035213;2015-12-26;CLI00682;FACTURA;49;1;175554;33355;208909
FAC0035214;2015-08-01;CLI00473;FACTURA;11;2;170073;32314;202387
FAC0035215;2015-04-17;CLI00036;FACTURA;19;1;155442;29534;184976
FAC0035216;2015-06-24;CLI00604;FACTURA;18;1;347100;65949;413049
FAC0035217;2015-07-12;CLI00693;FACTURA;11;2;159498;30305;189803
FAC0035218;2015-10-10;CLI00450;FACTURA;46;1;81372;15461;96833
FAC0035219;2015-03-08;CLI00041;FACTURA;18;2;203784;38719;242503
FAC0035220;2015-02-21;CLI00357;FACTURA;20;2;47230;8974;56204
FAC0035221;2015-11-17;CLI00188;FACTURA;43;1;43190;8206;51396
FAC0035222;2015-05-24;CLI00979;FACTURA;1;2;51005;9691;60696
FAC0035223;2015-10-16;CLI00118;FACTURA;20;1;174018;33063;207081
FAC0035224;2015-04-15;CLI00196;FACTURA;44;1;45816;8705;54521
FAC0035225;2015-01-04;CLI00857;FACTURA;12;2;76032;14446;90478
FAC0035226;2015-12-08;CLI00200;FACTURA;46;1;91314;17350;108664
FAC0035227;2015-07-21;CLI00793;FACTURA;30;2;252980;48066;301046
FAC0035228;2015-06-23;CLI00462;FACTURA;34;1;47676;9058;56734
FAC0035229;2015-04-18;CLI00234;FACTURA;33;1;163830;31128;194958
FAC0035230;2015-04-22;CLI00801;FACTURA;5;2;33844;6430;40274
FAC0035231;2015-07-27;CLI00047;FACTURA;42;2;188970;35904;224874
FAC0035232;2015-12-20;CLI00984;FACTURA;41;1;277680;52759;330439
FAC0035233;2015-09-04;CLI00044;FACTURA;34;1;136748;25982;162730
FAC0035234;2015-11-30;CLI00113;FACTURA;47;2;91809;17444;109253
FAC0035235;2015-03-12;CLI00877;FACTURA;6;2;348040;66128;414168
FAC0035236;2015-09-02;CLI00624;FACTURA;43;1;44412;8438;52850
FAC0035237;2015-11-04;CLI00316;FACTURA;37;1;130830;24858;155688
FAC0035238;2015-11-18;CLI00126;FACTURA;39;1;100791;19150;119941
FAC0035239;2015-08-11;CLI00476;FACTURA;5;1;202384;38453;240837
FAC0035240;2015-12-17;CLI00997;FACTURA;44;2;40686;7730;48416
FAC0035241;2015-06-03;CLI00025;FACTURA;10;2;91809;17444;109253
FAC0035242;2015-08-10;CLI00419;FACTURA;30;2;50742;9641;60383
FAC0035243;2015-06-26;CLI00243;FACTURA;17;2;32766;6226;38992
FAC0035244;2015-07-24;CLI00042;FACTURA;19;1;196596;37353;233949
FAC0035245;2015-09-26;CLI00672;FACTURA;30;1;68724;13058;81782
FAC0035246;2015-06-15;CLI00280;FACTURA;10;1;81729;15529;97258
FAC0035247;2015-03-05;CLI00643;FACTURA;18;2;85347;16216;101563
FAC0035248;2015-03-08;CLI00437;FACTURA;49;2;123340;23435;146775
FAC0035249;2015-04-15;CLI00284;FACTURA;33;1;79749;15152;94901
FAC0035250;2015-12-17;CLI00041;FACTURA;18;2;144315;27420;171735
FAC0035251;2015-08-02;CLI00932;FACTURA;13;1;34710;6595;41305
FAC0035252;2015-08-25;CLI00988;FACTURA;17;1;101624;19309;120933
FAC0035253;2015-06-26;CLI00510;FACTURA;33;1;158473;30110;188583
FAC0035254;2015-01-27;CLI00129;FACTURA;8;2;186081;35355;221436
FAC0035255;2015-06-08;CLI00343;FACTURA;38;2;14334;2723;17057
FAC0035256;2015-01-08;CLI00993;FACTURA;14;2;190053;36110;226163
FAC0035257;2015-05-31;CLI00585;FACTURA;33;2;174018;33063;207081
FAC0035258;2015-12-02;CLI00959;FACTURA;28;2;56380;10712;67092
FAC0035259;2015-03-07;CLI00327;FACTURA;11;2;107253;20378;127631
FAC0035260;2015-04-30;CLI00215;FACTURA;46;2;43610;8286;51896
FAC0035261;2015-09-18;CLI00787;FACTURA;11;2;193963;36853;230816
FAC0035262;2015-12-11;CLI00766;FACTURA;19;1;42194;8017;50211
FAC0035263;2015-07-03;CLI00302;FACTURA;32;1;126490;24033;150523
FAC0035264;2015-08-13;CLI00265;FACTURA;5;2;94485;17952;112437
FAC0035265;2015-02-26;CLI00057;FACTURA;27;2;119170;22642;141812
FAC0035266;2015-02-13;CLI00441;FACTURA;29;2;128280;24373;152653
FAC0035267;2015-03-24;CLI00892;FACTURA;38;1;26583;5051;31634
FAC0035268;2015-01-29;CLI00810;FACTURA;20;1;151176;28723;179899
FAC0035269;2015-12-26;CLI00068;FACTURA;26;1;27071;5143;32214
FAC0035270;2015-12-24;CLI00246;FACTURA;37;1;136215;25881;162096
FAC0035271;2015-01-17;CLI00985;FACTURA;8;2;85640;16272;101912
FAC0035272;2015-07-25;CLI00130;FACTURA;23;1;56691;10771;67462
FAC0035273;2015-08-27;CLI00431;FACTURA;15;2;25344;4815;30159
FAC0035274;2015-09-17;CLI00854;FACTURA;26;1;285080;54165;339245
FAC0035275;2015-06-07;CLI00060;FACTURA;35;1;166254;31588;197842
FAC0035276;2015-02-12;CLI00617;FACTURA;49;2;43610;8286;51896
FAC0035277;2015-11-24;CLI00707;FACTURA;9;2;20958;3982;24940
FAC0035278;2015-09-19;CLI00940;FACTURA;19;1;83832;15928;99760
FAC0035279;2015-08-05;CLI00067;FACTURA;17;2;76218;14481;90699
FAC0035280;2015-02-04;CLI00977;FACTURA;25;2;68374;12991;81365
FAC0035281;2015-05-04;CLI00666;FACTURA;39;1;261027;49595;310622
FAC0035282;2015-09-22;CLI00901;FACTURA;26;2;147679;28059;175738
FAC0035283;2015-11-22;CLI00437;FACTURA;25;2;40294;7656;47950
FAC0035284;2015-09-18;CLI00828;FACTURA;14;1;252980;48066;301046
FAC0035285;2015-07-26;CLI00738;FACTURA;29;1;202384;38453;240837
FAC0035286;2015-01-09;CLI00608;FACTURA;26;1;193963;36853;230816
FAC0035287;2015-07-20;CLI00785;FACTURA;9;2;214100;40679;254779
FAC0035288;2015-04-03;CLI00376;FACTURA;3;1;152436;28963;181399
FAC0035289;2015-07-07;CLI00459;FACTURA;20;2;86004;16341;102345
FAC0035290;2015-08-21;CLI00139;FACTURA;38;2;50812;9654;60466
FAC0035291;2015-12-07;CLI00278;FACTURA;47;1;80178;15234;95412
FAC0035292;2015-11-01;CLI00517;FACTURA;40;2;29003;5511;34514
FAC0035293;2015-04-22;CLI00832;FACTURA;9;1;20402;3876;24278
FAC0035294;2015-04-27;CLI00141;FACTURA;28;2;285080;54165;339245
FAC0035295;2015-07-28;CLI00703;FACTURA;31;2;205857;39113;244970
FAC0035296;2015-02-22;CLI00049;FACTURA;9;2;189497;36004;225501
FAC0035297;2015-04-12;CLI00774;FACTURA;30;1;151176;28723;179899
FAC0035298;2015-06-26;CLI00168;FACTURA;15;1;100791;19150;119941
FAC0035299;2015-04-29;CLI00192;FACTURA;18;1;302373;57451;359824
FAC0035300;2015-12-24;CLI00366;FACTURA;22;1;205122;38973;244095
FAC0035301;2015-02-08;CLI00970;FACTURA;28;1;88180;16754;104934
FAC0035302;2015-03-07;CLI00603;FACTURA;28;2;31437;5973;37410
FAC0035303;2015-05-06;CLI00116;FACTURA;17;1;79460;15097;94557
FAC0035304;2015-10-18;CLI00429;FACTURA;34;2;110836;21059;131895
FAC0035305;2015-09-19;CLI00540;FACTURA;17;1;114672;21788;136460
FAC0035306;2015-09-06;CLI00130;FACTURA;23;1;100791;19150;119941
FAC0035307;2015-05-24;CLI00746;FACTURA;15;1;33844;6430;40274
FAC0035308;2015-05-10;CLI00371;FACTURA;41;2;155442;29534;184976
FAC0035309;2015-08-11;CLI00077;FACTURA;44;2;313236;59515;372751
FAC0035310;2015-11-18;CLI00026;FACTURA;36;1;347100;65949;413049
FAC0035311;2015-12-09;CLI00926;FACTURA;30;1;84610;16076;100686
FAC0035312;2015-04-24;CLI00447;FACTURA;24;2;10146;1928;12074
FAC0035313;2015-01-23;CLI00170;FACTURA;38;1;75894;14420;90314
FAC0035314;2015-10-16;CLI00069;FACTURA;3;2;9446;1795;11241
FAC0035315;2015-08-23;CLI00643;FACTURA;17;2;24716;4696;29412
FAC0035316;2015-10-13;CLI00718;FACTURA;40;1;155442;29534;184976
FAC0035317;2015-04-26;CLI00263;FACTURA;35;2;140555;26705;167260
FAC0035318;2015-07-09;CLI00560;FACTURA;14;1;227682;43260;270942
FAC0035319;2015-07-05;CLI00466;FACTURA;47;1;159498;30305;189803
FAC0035320;2015-10-02;CLI00987;FACTURA;9;2;56691;10771;67462
FAC0035321;2015-04-26;CLI00732;FACTURA;29;1;70544;13403;83947
FAC0035322;2015-04-27;CLI00843;FACTURA;50;2;102561;19487;122048
FAC0035323;2015-09-11;CLI00339;FACTURA;21;2;83127;15794;98921
FAC0035324;2015-03-03;CLI00211;FACTURA;10;2;142540;27083;169623
FAC0035325;2015-10-05;CLI00463;FACTURA;10;2;109295;20766;130061
FAC0035326;2015-02-27;CLI00297;FACTURA;13;2;15892;3019;18911
FAC0035327;2015-03-31;CLI00244;FACTURA;28;1;23834;4528;28362
FAC0035328;2015-12-22;CLI00368;FACTURA;43;1;22873;4346;27219
FAC0035329;2015-01-24;CLI00067;FACTURA;21;2;33597;6383;39980
FAC0035330;2015-05-30;CLI00656;FACTURA;38;1;91492;17383;108875
FAC0035331;2015-06-24;CLI00877;FACTURA;2;2;20147;3828;23975
FAC0035332;2015-01-23;CLI00683;FACTURA;24;2;256572;48749;305321
FAC0035333;2015-05-12;CLI00609;FACTURA;29;2;226390;43014;269404
FAC0035334;2015-10-23;CLI00515;FACTURA;5;2;71502;13585;85087
FAC0035335;2015-03-15;CLI00467;FACTURA;24;2;25344;4815;30159
FAC0035336;2015-10-05;CLI00223;FACTURA;11;2;81372;15461;96833
FAC0035337;2015-08-05;CLI00641;FACTURA;21;2;59585;11321;70906
FAC0035338;2015-12-16;CLI00043;FACTURA;24;2;10479;1991;12470
FAC0035339;2015-07-26;CLI00785;FACTURA;27;2;254730;48399;303129
FAC0035340;2015-09-10;CLI00414;FACTURA;7;1;158473;30110;188583
FAC0035341;2015-11-07;CLI00973;FACTURA;41;2;33792;6420;40212
FAC0035342;2015-12-01;CLI00325;FACTURA;15;2;84480;16051;100531
FAC0035343;2015-01-19;CLI00858;FACTURA;46;1;139216;26451;165667
FAC0035344;2015-04-19;CLI00403;FACTURA;32;2;37784;7179;44963
FAC0035345;2015-05-19;CLI00549;FACTURA;37;2;25473;4840;30313
FAC0035346;2015-11-02;CLI00969;FACTURA;8;2;61206;11629;72835
FAC0035347;2015-01-17;CLI00966;FACTURA;4;1;94460;17947;112407
FAC0035348;2015-03-20;CLI00580;FACTURA;37;1;24716;4696;29412
FAC0035349;2015-10-25;CLI00664;FACTURA;27;1;66381;12612;78993
FAC0035350;2015-02-06;CLI00620;FACTURA;7;1;242970;46164;289134
FAC0035351;2015-05-27;CLI00989;FACTURA;48;2;21410;4068;25478
FAC0035352;2015-08-30;CLI00471;FACTURA;10;2;25298;4807;30105
FAC0035353;2015-06-11;CLI00651;FACTURA;8;2;142401;27056;169457
FAC0035354;2015-10-05;CLI00548;FACTURA;38;1;147679;28059;175738
FAC0035355;2015-02-06;CLI00169;FACTURA;20;2;13674;2598;16272
FAC0035356;2015-01-08;CLI00522;FACTURA;19;1;100338;19064;119402
FAC0035357;2015-03-22;CLI00038;FACTURA;25;1;30603;5815;36418
FAC0035358;2015-12-08;CLI00830;FACTURA;13;1;262128;49804;311932
FAC0035359;2015-10-02;CLI00296;FACTURA;47;1;168936;32098;201034
FAC0035360;2015-05-07;CLI00762;FACTURA;19;1;137238;26075;163313
FAC0035361;2015-05-09;CLI00134;FACTURA;24;1;17636;3351;20987
FAC0035362;2015-02-20;CLI00935;FACTURA;14;2;63291;12025;75316
FAC0035363;2015-11-02;CLI00464;FACTURA;47;1;81608;15506;97114
FAC0035364;2015-11-27;CLI00950;FACTURA;28;1;14334;2723;17057
FAC0035365;2015-08-22;CLI00372;FACTURA;43;1;313236;59515;372751
FAC0035366;2015-12-30;CLI00709;FACTURA;46;2;34362;6529;40891
FAC0035367;2015-12-30;CLI00238;FACTURA;23;1;141088;26807;167895
FAC0035368;2015-01-23;CLI00804;FACTURA;16;1;75568;14358;89926
FAC0035369;2015-09-17;CLI00724;FACTURA;44;1;169220;32152;201372
FAC0035370;2015-12-13;CLI00427;FACTURA;23;2;49226;9353;58579
FAC0035371;2015-04-29;CLI00269;FACTURA;13;2;201470;38279;239749
FAC0035372;2015-09-23;CLI00282;FACTURA;13;1;211170;40122;251292
FAC0035373;2015-11-12;CLI00132;FACTURA;27;1;229257;43559;272816
FAC0035374;2015-10-09;CLI00119;FACTURA;32;2;277680;52759;330439
FAC0035375;2015-04-24;CLI00512;FACTURA;50;1;47668;9057;56725
FAC0035376;2015-08-20;CLI00555;FACTURA;19;2;127365;24199;151564
FAC0035377;2015-08-27;CLI00080;FACTURA;14;1;45104;8570;53674
FAC0035378;2015-12-30;CLI00723;FACTURA;33;2;40584;7711;48295
FAC0035379;2015-01-10;CLI00723;FACTURA;39;2;63568;12078;75646
FAC0035380;2015-04-22;CLI00438;FACTURA;43;1;212664;40406;253070
FAC0035381;2015-10-16;CLI00252;FACTURA;11;1;40584;7711;48295
FAC0035382;2015-09-07;CLI00379;FACTURA;7;2;278432;52902;331334
FAC0035383;2015-08-15;CLI00719;FACTURA;47;2;43610;8286;51896
FAC0035384;2015-11-18;CLI00931;FACTURA;39;2;107050;20340;127390
FAC0035385;2015-01-21;CLI00586;FACTURA;50;1;94311;17919;112230
FAC0035386;2015-10-11;CLI00191;FACTURA;35;2;37074;7044;44118
FAC0035387;2015-01-03;CLI00560;FACTURA;3;1;109295;20766;130061
FAC0035388;2015-06-08;CLI00163;FACTURA;24;2;159498;30305;189803
FAC0035389;2015-09-15;CLI00418;FACTURA;37;1;174018;33063;207081
FAC0035390;2015-12-19;CLI00845;FACTURA;39;2;285080;54165;339245
FAC0035391;2015-04-06;CLI00029;FACTURA;14;2;65532;12451;77983
FAC0035392;2015-04-16;CLI00674;FACTURA;7;1;143340;27235;170575
FAC0035393;2015-10-05;CLI00445;FACTURA;42;2;192690;36611;229301
FAC0035394;2015-05-11;CLI00778;FACTURA;7;1;59136;11236;70372
FAC0035395;2015-04-18;CLI00068;FACTURA;41;1;50812;9654;60466
FAC0035396;2015-04-06;CLI00205;FACTURA;15;2;155442;29534;184976
FAC0035397;2015-10-31;CLI00491;FACTURA;50;2;136215;25881;162096
FAC0035398;2015-12-28;CLI00094;FACTURA;5;1;168936;32098;201034
FAC0035399;2015-01-11;CLI00216;FACTURA;39;1;152838;29039;181877
FAC0035400;2015-05-10;CLI00696;FACTURA;50;1;57016;10833;67849
FAC0035401;2015-11-03;CLI00819;FACTURA;37;2;75568;14358;89926
FAC0035402;2015-06-20;CLI00086;FACTURA;30;1;43190;8206;51396
FAC0035403;2015-05-21;CLI00783;FACTURA;14;2;56691;10771;67462
FAC0035404;2015-12-05;CLI00666;FACTURA;23;1;122058;23191;145249
FAC0035405;2015-04-03;CLI00661;FACTURA;3;2;171048;32499;203547
FAC0035406;2015-09-16;CLI00356;FACTURA;42;1;94460;17947;112407
FAC0035407;2015-01-27;CLI00436;FACTURA;28;1;42194;8017;50211
FAC0035408;2015-02-02;CLI00895;FACTURA;6;2;197344;37495;234839
FAC0035409;2015-04-01;CLI00263;FACTURA;37;2;65577;12460;78037
FAC0035410;2015-10-03;CLI00976;FACTURA;45;1;68370;12990;81360
FAC0035411;2015-04-02;CLI00191;FACTURA;24;2;84610;16076;100686
FAC0035412;2015-04-21;CLI00007;FACTURA;16;2;20402;3876;24278
FAC0035413;2015-05-14;CLI00748;FACTURA;34;1;151788;28840;180628
FAC0035414;2015-10-06;CLI00416;FACTURA;40;1;108284;20574;128858
FAC0035415;2015-03-23;CLI00142;FACTURA;1;1;108284;20574;128858
FAC0035416;2015-10-05;CLI00240;FACTURA;22;1;272430;51762;324192
FAC0035417;2015-03-26;CLI00219;FACTURA;41;2;63291;12025;75316
FAC0035418;2015-10-12;CLI00205;FACTURA;31;2;152298;28937;181235
FAC0035419;2015-03-16;CLI00472;FACTURA;33;1;52908;10053;62961
FAC0035420;2015-03-10;CLI00776;FACTURA;27;1;20147;3828;23975
FAC0035421;2015-11-05;CLI00983;FACTURA;29;2;55622;10568;66190
FAC0035422;2015-09-18;CLI00983;FACTURA;29;2;71670;13617;85287
FAC0035423;2015-08-21;CLI00480;FACTURA;32;1;21859;4153;26012
FAC0035424;2015-07-10;CLI00022;FACTURA;28;1;117036;22237;139273
FAC0035425;2015-03-10;CLI00125;FACTURA;44;2;50946;9680;60626
FAC0035426;2015-12-27;CLI00395;FACTURA;3;2;59585;11321;70906
FAC0035427;2015-12-22;CLI00667;FACTURA;13;2;138545;26324;164869
FAC0035428;2015-10-20;CLI00484;FACTURA;38;1;56222;10682;66904
FAC0035429;2015-08-12;CLI00662;FACTURA;47;1;30603;5815;36418
FAC0035430;2015-07-23;CLI00970;FACTURA;4;1;28111;5341;33452
FAC0035431;2015-12-25;CLI00966;FACTURA;36;1;151788;28840;180628
FAC0035432;2015-01-13;CLI00782;FACTURA;23;1;181323;34451;215774
FAC0035433;2015-08-14;CLI00260;FACTURA;44;1;58006;11021;69027
FAC0035434;2015-12-04;CLI00581;FACTURA;27;2;144315;27420;171735
FAC0035435;2015-12-26;CLI00918;FACTURA;47;1;203751;38713;242464
FAC0035436;2015-10-16;CLI00297;FACTURA;2;2;232024;44085;276109
FAC0035437;2015-12-31;CLI00414;FACTURA;30;1;15892;3019;18911
FAC0035438;2015-03-29;CLI00789;FACTURA;46;2;37794;7181;44975
FAC0035439;2015-05-26;CLI00626;FACTURA;43;1;122058;23191;145249
FAC0035440;2015-04-01;CLI00259;FACTURA;24;2;79749;15152;94901
FAC0035441;2015-12-08;CLI00414;FACTURA;47;1;177086;33646;210732
FAC0035442;2015-11-24;CLI00253;FACTURA;9;2;85524;16250;101774
FAC0035443;2015-12-01;CLI00548;FACTURA;44;1;111030;21096;132126
FAC0035444;2015-03-18;CLI00071;FACTURA;16;2;91809;17444;109253
FAC0035445;2015-04-03;CLI00848;FACTURA;49;1;239309;45469;284778
FAC0035446;2015-09-11;CLI00132;FACTURA;25;1;64230;12204;76434
FAC0035447;2015-02-21;CLI00581;FACTURA;37;2;170073;32314;202387
FAC0035448;2015-05-03;CLI00637;FACTURA;8;2;246680;46869;293549
FAC0035449;2015-12-02;CLI00485;FACTURA;41;2;32070;6093;38163
FAC0035450;2015-09-03;CLI00254;FACTURA;50;1;30603;5815;36418
FAC0035451;2015-10-19;CLI00947;FACTURA;16;2;138840;26380;165220
FAC0035452;2015-12-21;CLI00198;FACTURA;22;1;87220;16572;103792
FAC0035453;2015-04-05;CLI00030;FACTURA;10;1;12340;2345;14685
FAC0035454;2015-11-30;CLI00893;FACTURA;8;2;126490;24033;150523
FAC0035455;2015-11-07;CLI00445;FACTURA;32;2;102561;19487;122048
FAC0035456;2015-08-05;CLI00600;FACTURA;22;1;67194;12767;79961
FAC0035457;2015-11-09;CLI00554;FACTURA;10;1;50946;9680;60626
FAC0035458;2015-02-05;CLI00516;FACTURA;47;1;68374;12991;81365
FAC0035459;2015-11-11;CLI00541;FACTURA;10;2;246680;46869;293549
FAC0035460;2015-02-17;CLI00798;FACTURA;6;1;208824;39677;248501
FAC0035461;2015-01-06;CLI00331;FACTURA;39;2;18510;3517;22027
FAC0035462;2015-03-17;CLI00335;FACTURA;34;2;76419;14520;90939
FAC0035463;2015-07-13;CLI00759;FACTURA;15;2;91809;17444;109253
FAC0035464;2015-01-10;CLI00792;FACTURA;46;1;45746;8692;54438
FAC0035465;2015-11-28;CLI00358;FACTURA;27;1;32766;6226;38992
FAC0035466;2015-10-29;CLI00682;FACTURA;2;1;75568;14358;89926
FAC0035467;2015-04-24;CLI00360;FACTURA;14;1;68619;13038;81657
FAC0035468;2015-08-18;CLI00918;FACTURA;31;1;307683;58460;366143
FAC0035469;2015-10-18;CLI00052;FACTURA;24;1;189873;36076;225949
FAC0035470;2015-11-11;CLI00378;FACTURA;2;1;37074;7044;44118
FAC0035471;2015-06-20;CLI00959;FACTURA;44;2;114032;21666;135698
FAC0035472;2015-05-21;CLI00325;FACTURA;10;2;42234;8024;50258
FAC0035473;2015-03-30;CLI00670;FACTURA;21;1;94460;17947;112407
FAC0035474;2015-07-02;CLI00564;FACTURA;47;1;61700;11723;73423
FAC0035475;2015-07-18;CLI00451;FACTURA;35;2;37020;7034;44054
FAC0035476;2015-04-03;CLI00913;FACTURA;50;2;50688;9631;60319
FAC0035477;2015-10-12;CLI00862;FACTURA;26;1;128460;24407;152867
FAC0035478;2015-09-29;CLI00120;FACTURA;50;1;163458;31057;194515
FAC0035479;2015-11-23;CLI00517;FACTURA;22;2;158724;30158;188882
FAC0035480;2015-11-02;CLI00731;FACTURA;9;2;87436;16613;104049
FAC0035481;2015-01-28;CLI00973;FACTURA;29;2;261027;49595;310622
FAC0035482;2015-06-05;CLI00567;FACTURA;44;2;81729;15529;97258
FAC0035483;2015-09-16;CLI00104;FACTURA;20;1;17636;3351;20987
FAC0035484;2015-05-30;CLI00154;FACTURA;30;1;45278;8603;53881
FAC0035485;2015-03-04;CLI00320;FACTURA;16;1;103086;19586;122672
FAC0035486;2015-02-02;CLI00080;FACTURA;43;1;78024;14825;92849
FAC0035487;2015-05-12;CLI00018;FACTURA;5;1;127030;24136;151166
FAC0035488;2015-05-21;CLI00495;FACTURA;19;2;28449;5405;33854
FAC0035489;2015-04-02;CLI00030;FACTURA;41;1;63351;12037;75388
FAC0035490;2015-05-22;CLI00083;FACTURA;20;2;31437;5973;37410
FAC0035491;2015-02-20;CLI00625;FACTURA;13;2;20958;3982;24940
FAC0035492;2015-06-12;CLI00742;FACTURA;23;1;60441;11484;71925
FAC0035493;2015-05-04;CLI00492;FACTURA;33;1;41916;7964;49880
FAC0035494;2015-01-28;CLI00453;FACTURA;18;2;76218;14481;90699
FAC0035495;2015-01-26;CLI00138;FACTURA;40;1;232024;44085;276109
FAC0035496;2015-05-10;CLI00905;FACTURA;3;2;197344;37495;234839
FAC0035497;2015-03-18;CLI00388;FACTURA;19;1;168666;32047;200713
FAC0035498;2015-08-03;CLI00014;FACTURA;45;1;229362;43579;272941
FAC0035499;2015-06-26;CLI00459;FACTURA;17;2;58518;11118;69636
FAC0035500;2015-08-07;CLI00923;FACTURA;40;2;81608;15506;97114
FAC0035501;2015-09-01;CLI00300;FACTURA;24;1;18966;3604;22570
FAC0035502;2015-10-30;CLI00877;FACTURA;36;2;22639;4301;26940
FAC0035503;2015-10-14;CLI00141;FACTURA;45;2;245187;46586;291773
FAC0035504;2015-05-05;CLI00134;FACTURA;9;1;273496;51964;325460
FAC0035505;2015-09-03;CLI00747;FACTURA;44;2;20292;3855;24147
FAC0035506;2015-08-10;CLI00176;FACTURA;10;1;33792;6420;40212
FAC0035507;2015-01-20;CLI00704;FACTURA;48;1;176360;33508;209868
FAC0035508;2015-02-13;CLI00890;FACTURA;44;1;16896;3210;20106
FAC0035509;2015-12-23;CLI00116;FACTURA;11;1;22908;4353;27261
FAC0035510;2015-10-29;CLI00311;FACTURA;1;2;9446;1795;11241
FAC0035511;2015-04-18;CLI00112;FACTURA;23;1;141029;26796;167825
FAC0035512;2015-12-24;CLI00525;FACTURA;39;2;210970;40084;251054
FAC0035513;2015-08-26;CLI00763;FACTURA;23;2;183087;34787;217874
FAC0035514;2015-12-11;CLI00499;FACTURA;31;2;21097;4008;25105
FAC0035515;2015-06-18;CLI00099;FACTURA;1;2;140555;26705;167260
FAC0035516;2015-08-06;CLI00144;FACTURA;46;1;151788;28840;180628
FAC0035517;2015-05-02;CLI00015;FACTURA;21;2;177842;33790;211632
FAC0035518;2015-02-12;CLI00091;FACTURA;21;2;265830;50508;316338
FAC0035519;2015-08-31;CLI00726;FACTURA;48;1;226390;43014;269404
FAC0035520;2015-05-12;CLI00991;FACTURA;1;2;199556;37916;237472
FAC0035521;2015-01-11;CLI00625;FACTURA;45;2;54142;10287;64429
FAC0035522;2015-05-21;CLI00915;FACTURA;20;2;149870;28475;178345
FAC0035523;2015-09-04;CLI00285;FACTURA;13;2;189873;36076;225949
FAC0035524;2015-08-24;CLI00084;FACTURA;37;1;66381;12612;78993
FAC0035525;2015-04-12;CLI00568;FACTURA;17;1;285080;54165;339245
FAC0035526;2015-09-17;CLI00637;FACTURA;13;2;13674;2598;16272
FAC0035527;2015-02-25;CLI00906;FACTURA;14;1;222012;42182;264194
FAC0035528;2015-12-30;CLI00968;FACTURA;5;1;256572;48749;305321
FAC0035529;2015-08-06;CLI00604;FACTURA;17;1;90556;17206;107762
FAC0035530;2015-01-27;CLI00986;FACTURA;22;1;14334;2723;17057
FAC0035531;2015-06-04;CLI00540;FACTURA;25;1;203751;38713;242464
FAC0035532;2015-03-02;CLI00633;FACTURA;8;2;25406;4827;30233
FAC0035533;2015-09-03;CLI00320;FACTURA;9;1;57270;10881;68151
FAC0035534;2015-08-20;CLI00834;FACTURA;30;1;158473;30110;188583
FAC0035535;2015-08-05;CLI00545;FACTURA;46;2;22639;4301;26940
FAC0035536;2015-06-17;CLI00240;FACTURA;44;1;42820;8136;50956
FAC0035537;2015-05-27;CLI00356;FACTURA;28;1;111030;21096;132126
FAC0035538;2015-04-23;CLI00444;FACTURA;26;1;161176;30623;191799
FAC0035539;2015-04-04;CLI00492;FACTURA;38;1;47415;9009;56424
FAC0035540;2015-12-21;CLI00734;FACTURA;32;1;56691;10771;67462
FAC0035541;2015-06-12;CLI00099;FACTURA;12;2;96210;18280;114490
FAC0035542;2015-05-07;CLI00234;FACTURA;38;1;278432;52902;331334
FAC0035543;2015-12-29;CLI00501;FACTURA;9;2;158473;30110;188583
FAC0035544;2015-09-07;CLI00011;FACTURA;30;2;254730;48399;303129
FAC0035545;2015-07-02;CLI00709;FACTURA;39;2;97530;18531;116061
FAC0035546;2015-09-20;CLI00738;FACTURA;36;1;103086;19586;122672
FAC0035547;2015-05-13;CLI00417;FACTURA;22;2;177648;33753;211401
FAC0035548;2015-09-19;CLI00071;FACTURA;50;2;33828;6427;40255
FAC0035549;2015-10-27;CLI00204;FACTURA;15;1;32272;6132;38404
FAC0035550;2015-03-20;CLI00254;FACTURA;47;1;47668;9057;56725
FAC0035551;2015-11-30;CLI00048;FACTURA;15;1;50946;9680;60626
FAC0035552;2015-02-10;CLI00731;FACTURA;25;2;174018;33063;207081
FAC0035553;2015-08-13;CLI00711;FACTURA;30;2;57336;10894;68230
FAC0035554;2015-08-04;CLI00981;FACTURA;43;2;196245;37287;233532
FAC0035555;2015-06-30;CLI00668;FACTURA;46;1;142540;27083;169623
FAC0035556;2015-04-13;CLI00800;FACTURA;39;1;45278;8603;53881
FAC0035557;2015-05-17;CLI00467;FACTURA;32;2;192690;36611;229301
FAC0035558;2015-03-09;CLI00697;FACTURA;4;2;143340;27235;170575
FAC0035559;2015-11-25;CLI00842;FACTURA;37;1;37784;7179;44963
FAC0035560;2015-06-23;CLI00933;FACTURA;45;2;229362;43579;272941
FAC0035561;2015-07-11;CLI00532;FACTURA;31;1;75894;14420;90314
FAC0035562;2015-07-09;CLI00383;FACTURA;25;2;205122;38973;244095
FAC0035563;2015-07-29;CLI00553;FACTURA;9;2;63351;12037;75388
FAC0035564;2015-11-01;CLI00020;FACTURA;18;1;103086;19586;122672
FAC0035565;2015-06-23;CLI00660;FACTURA;21;1;39730;7549;47279
FAC0035566;2015-01-13;CLI00180;FACTURA;31;1;45104;8570;53674
FAC0035567;2015-05-27;CLI00914;FACTURA;49;1;136740;25981;162721
FAC0035568;2015-07-06;CLI00377;FACTURA;16;2;212664;40406;253070
FAC0035569;2015-09-17;CLI00430;FACTURA;36;1;252999;48070;301069
FAC0035570;2015-11-26;CLI00009;FACTURA;23;2;81729;15529;97258
FAC0035571;2015-05-07;CLI00627;FACTURA;5;2;151176;28723;179899
FAC0035572;2015-11-09;CLI00690;FACTURA;6;1;37794;7181;44975
FAC0035573;2015-07-02;CLI00398;FACTURA;2;1;172291;32735;205026
FAC0035574;2015-05-19;CLI00453;FACTURA;11;2;82044;15588;97632
FAC0035575;2015-08-24;CLI00294;FACTURA;44;1;104130;19785;123915
FAC0035576;2015-06-06;CLI00433;FACTURA;10;2;59585;11321;70906
FAC0035577;2015-11-01;CLI00648;FACTURA;16;1;22206;4219;26425
FAC0035578;2015-08-22;CLI00242;FACTURA;7;1;199854;37972;237826
FAC0035579;2015-05-10;CLI00918;FACTURA;36;1;147679;28059;175738
FAC0035580;2015-07-22;CLI00067;FACTURA;37;2;173550;32975;206525
FAC0035581;2015-01-18;CLI00168;FACTURA;39;1;101624;19309;120933
FAC0035582;2015-06-06;CLI00866;FACTURA;27;1;34710;6595;41305
FAC0035583;2015-07-23;CLI00052;FACTURA;24;1;14334;2723;17057
FAC0035584;2015-12-10;CLI00959;FACTURA;50;2;43610;8286;51896
FAC0035585;2015-07-15;CLI00054;FACTURA;33;1;31784;6039;37823
FAC0035586;2015-02-24;CLI00900;FACTURA;30;1;166254;31588;197842
FAC0035587;2015-01-10;CLI00321;FACTURA;29;2;100735;19140;119875
FAC0035588;2015-10-07;CLI00459;FACTURA;2;2;134388;25534;159922
FAC0035589;2015-04-24;CLI00144;FACTURA;29;1;30438;5783;36221
FAC0035590;2015-02-12;CLI00984;FACTURA;34;1;221672;42118;263790
FAC0035591;2015-01-11;CLI00896;FACTURA;50;1;22873;4346;27219
FAC0035592;2015-09-19;CLI00013;FACTURA;14;2;111030;21096;132126
FAC0035593;2015-03-02;CLI00923;FACTURA;27;2;40584;7711;48295
FAC0035594;2015-06-25;CLI00920;FACTURA;35;1;30850;5862;36712
FAC0035595;2015-04-24;CLI00911;FACTURA;15;2;42820;8136;50956
FAC0035596;2015-11-01;CLI00724;FACTURA;43;1;268776;51067;319843
FAC0035597;2015-02-17;CLI00451;FACTURA;14;2;73353;13937;87290
FAC0035598;2015-10-05;CLI00137;FACTURA;3;2;127365;24199;151564
FAC0035599;2015-05-12;CLI00737;FACTURA;26;2;109295;20766;130061
FAC0035600;2015-09-19;CLI00034;FACTURA;49;1;131064;24902;155966
FAC0035601;2015-07-06;CLI00824;FACTURA;16;1;107253;20378;127631
FAC0035602;2015-06-01;CLI00048;FACTURA;18;1;25344;4815;30159
FAC0035603;2015-01-26;CLI00335;FACTURA;47;2;32766;6226;38992
FAC0035604;2015-10-16;CLI00639;FACTURA;14;2;81168;15422;96590
FAC0035605;2015-11-11;CLI00826;FACTURA;45;1;186081;35355;221436
FAC0035606;2015-08-17;CLI00184;FACTURA;37;1;57016;10833;67849
FAC0035607;2015-10-21;CLI00720;FACTURA;47;1;128280;24373;152653
FAC0035608;2015-05-21;CLI00621;FACTURA;5;2;218050;41430;259480
FAC0035609;2015-12-23;CLI00494;FACTURA;10;1;109025;20715;129740
FAC0035610;2015-06-12;CLI00850;FACTURA;4;1;228730;43459;272189
FAC0035611;2015-07-23;CLI00576;FACTURA;46;1;15892;3019;18911
FAC0035612;2015-07-21;CLI00983;FACTURA;17;2;28508;5417;33925
FAC0035613;2015-07-21;CLI00058;FACTURA;8;1;68724;13058;81782
FAC0035614;2015-10-07;CLI00166;FACTURA;14;1;151788;28840;180628
FAC0035615;2015-04-14;CLI00089;FACTURA;3;2;229362;43579;272941
FAC0035616;2015-08-04;CLI00843;FACTURA;24;2;88824;16877;105701
FAC0035617;2015-06-29;CLI00195;FACTURA;22;2;227682;43260;270942
FAC0035618;2015-07-21;CLI00371;FACTURA;7;2;285080;54165;339245
FAC0035619;2015-06-28;CLI00387;FACTURA;23;2;290030;55106;345136
FAC0035620;2015-05-02;CLI00207;FACTURA;37;2;71022;13494;84516
FAC0035621;2015-05-17;CLI00150;FACTURA;24;1;254060;48271;302331
FAC0035622;2015-06-04;CLI00737;FACTURA;34;2;30895;5870;36765
FAC0035623;2015-06-21;CLI00690;FACTURA;47;1;199556;37916;237472
FAC0035624;2015-07-19;CLI00025;FACTURA;12;2;170935;32478;203413
FAC0035625;2015-12-15;CLI00272;FACTURA;9;1;25344;4815;30159
FAC0035626;2015-04-06;CLI00750;FACTURA;14;1;35751;6793;42544
FAC0035627;2015-05-12;CLI00663;FACTURA;21;2;151176;28723;179899
FAC0035628;2015-08-05;CLI00574;FACTURA;4;1;81372;15461;96833
FAC0035629;2015-02-11;CLI00511;FACTURA;23;2;262128;49804;311932
FAC0035630;2015-08-28;CLI00762;FACTURA;36;1;56691;10771;67462
FAC0035631;2015-03-09;CLI00854;FACTURA;30;1;48408;9198;57606
FAC0035632;2015-03-18;CLI00336;FACTURA;45;1;81729;15529;97258
FAC0035633;2015-06-27;CLI00213;FACTURA;1;2;81608;15506;97114
FAC0035634;2015-10-16;CLI00180;FACTURA;23;1;123340;23435;146775
FAC0035635;2015-06-27;CLI00010;FACTURA;24;1;104412;19838;124250
FAC0035636;2015-09-24;CLI00947;FACTURA;29;2;131154;24919;156073
FAC0035637;2015-12-22;CLI00185;FACTURA;43;2;18966;3604;22570
FAC0035638;2015-10-19;CLI00367;FACTURA;15;2;65577;12460;78037
FAC0035639;2015-08-16;CLI00912;FACTURA;22;1;254060;48271;302331
FAC0035640;2015-06-22;CLI00874;FACTURA;47;1;222060;42191;264251
FAC0035641;2015-07-19;CLI00054;FACTURA;13;1;134388;25534;159922
FAC0035642;2015-05-23;CLI00293;FACTURA;14;2;62874;11946;74820
FAC0035643;2015-01-16;CLI00884;FACTURA;27;1;151788;28840;180628
FAC0035644;2015-04-17;CLI00270;FACTURA;38;1;151788;28840;180628
FAC0035645;2015-01-15;CLI00313;FACTURA;45;2;252980;48066;301046
FAC0035646;2015-02-24;CLI00003;FACTURA;19;2;56691;10771;67462
FAC0035647;2015-01-08;CLI00285;FACTURA;5;2;30603;5815;36418
FAC0035648;2015-09-03;CLI00348;FACTURA;6;1;222060;42191;264251
FAC0035649;2015-01-25;CLI00766;FACTURA;33;1;208260;39569;247829
FAC0035650;2015-08-01;CLI00806;FACTURA;26;1;235179;44684;279863
FAC0035651;2015-07-17;CLI00546;FACTURA;49;1;160350;30467;190817
FAC0035652;2015-09-07;CLI00366;FACTURA;17;1;47230;8974;56204
FAC0035653;2015-08-19;CLI00025;FACTURA;20;2;13674;2598;16272
FAC0035654;2015-09-04;CLI00118;FACTURA;14;1;203784;38719;242503
FAC0035655;2015-07-14;CLI00844;FACTURA;49;1;20292;3855;24147
FAC0035656;2015-12-29;CLI00007;FACTURA;34;2;27709;5265;32974
FAC0035657;2015-09-28;CLI00745;FACTURA;3;2;217944;41409;259353
FAC0035658;2015-09-13;CLI00158;FACTURA;8;1;168666;32047;200713
FAC0035659;2015-09-09;CLI00967;FACTURA;8;2;114540;21763;136303
FAC0035660;2015-10-21;CLI00010;FACTURA;37;1;196245;37287;233532
FAC0035661;2015-05-12;CLI00348;FACTURA;22;1;54696;10392;65088
FAC0035662;2015-05-18;CLI00619;FACTURA;37;2;341870;64955;406825
FAC0035663;2015-09-09;CLI00763;FACTURA;13;2;34362;6529;40891
FAC0035664;2015-04-12;CLI00978;FACTURA;36;1;55622;10568;66190
FAC0035665;2015-07-17;CLI00756;FACTURA;45;1;30895;5870;36765
FAC0035666;2015-07-09;CLI00555;FACTURA;35;2;85524;16250;101774
FAC0035667;2015-08-10;CLI00033;FACTURA;22;2;6170;1172;7342
FAC0035668;2015-07-07;CLI00621;FACTURA;41;2;59136;11236;70372
FAC0035669;2015-08-16;CLI00751;FACTURA;11;2;84610;16076;100686
FAC0035670;2015-05-03;CLI00766;FACTURA;45;1;153013;29072;182085
FAC0035671;2015-12-03;CLI00057;FACTURA;17;2;273496;51964;325460
FAC0035672;2015-05-21;CLI00457;FACTURA;24;2;252980;48066;301046
FAC0035673;2015-05-31;CLI00793;FACTURA;25;2;67917;12904;80821
FAC0035674;2015-08-29;CLI00796;FACTURA;13;1;273496;51964;325460
FAC0035675;2015-08-20;CLI00154;FACTURA;38;1;30850;5862;36712
FAC0035676;2015-04-14;CLI00470;FACTURA;7;1;137238;26075;163313
FAC0035677;2015-10-30;CLI00027;FACTURA;1;2;190053;36110;226163
FAC0035678;2015-10-25;CLI00880;FACTURA;23;1;261027;49595;310622
FAC0035679;2015-10-16;CLI00686;FACTURA;29;1;203248;38617;241865
FAC0035680;2015-01-23;CLI00318;FACTURA;14;1;43718;8306;52024
FAC0035681;2015-11-28;CLI00648;FACTURA;19;1;210970;40084;251054
FAC0035682;2015-09-20;CLI00162;FACTURA;38;1;84388;16034;100422
FAC0035683;2015-01-16;CLI00738;FACTURA;31;1;40804;7753;48557
FAC0035684;2015-07-07;CLI00348;FACTURA;17;1;270710;51435;322145
FAC0035685;2015-02-24;CLI00966;FACTURA;23;1;171048;32499;203547
FAC0035686;2015-05-09;CLI00056;FACTURA;36;1;294894;56030;350924
FAC0035687;2015-08-29;CLI00300;FACTURA;29;1;196777;37388;234165
FAC0035688;2015-03-30;CLI00672;FACTURA;23;1;29003;5511;34514
FAC0035689;2015-03-05;CLI00856;FACTURA;35;1;60876;11566;72442
FAC0035690;2015-10-30;CLI00701;FACTURA;22;2;254060;48271;302331
FAC0035691;2015-12-08;CLI00230;FACTURA;27;1;52908;10053;62961
FAC0035692;2015-06-07;CLI00808;FACTURA;25;1;152436;28963;181399
FAC0035693;2015-03-13;CLI00450;FACTURA;28;1;152436;28963;181399
FAC0035694;2015-02-24;CLI00877;FACTURA;46;2;16922;3215;20137
FAC0035695;2015-07-02;CLI00536;FACTURA;2;1;55622;10568;66190
FAC0035696;2015-06-27;CLI00702;FACTURA;16;1;126490;24033;150523
FAC0035697;2015-12-16;CLI00630;FACTURA;20;1;168666;32047;200713
FAC0035698;2015-01-28;CLI00436;FACTURA;4;1;39730;7549;47279
FAC0035699;2015-10-30;CLI00996;FACTURA;20;1;17636;3351;20987
FAC0035700;2015-09-02;CLI00647;FACTURA;20;2;142401;27056;169457
FAC0035701;2015-03-06;CLI00890;FACTURA;49;1;52908;10053;62961
FAC0035702;2015-07-04;CLI00979;FACTURA;42;2;126490;24033;150523
FAC0035703;2015-02-01;CLI00638;FACTURA;6;1;17636;3351;20987
FAC0035704;2015-02-15;CLI00185;FACTURA;38;2;193963;36853;230816
FAC0035705;2015-06-06;CLI00709;FACTURA;45;2;64230;12204;76434
FAC0035706;2015-08-05;CLI00628;FACTURA;27;1;135355;25717;161072
FAC0035707;2015-02-03;CLI00516;FACTURA;46;1;20958;3982;24940
FAC0035708;2015-01-26;CLI00156;FACTURA;2;1;307683;58460;366143
FAC0035709;2015-01-09;CLI00708;FACTURA;32;1;84610;16076;100686
FAC0035710;2015-08-17;CLI00818;FACTURA;1;1;205122;38973;244095
FAC0035711;2015-10-25;CLI00851;FACTURA;33;2;102561;19487;122048
FAC0035712;2015-02-04;CLI00887;FACTURA;14;2;41916;7964;49880
FAC0035713;2015-06-16;CLI00359;FACTURA;41;2;104130;19785;123915
FAC0035714;2015-03-30;CLI00425;FACTURA;44;2;18966;3604;22570
FAC0035715;2015-08-20;CLI00234;FACTURA;50;1;65532;12451;77983
FAC0035716;2015-01-06;CLI00332;FACTURA;39;1;203248;38617;241865
FAC0035717;2015-05-21;CLI00785;FACTURA;40;2;127030;24136;151166
FAC0035718;2015-11-17;CLI00337;FACTURA;8;2;6170;1172;7342
FAC0035719;2015-12-05;CLI00067;FACTURA;27;2;54142;10287;64429
FAC0035720;2015-07-11;CLI00319;FACTURA;39;2;52908;10053;62961
FAC0035721;2015-03-21;CLI00957;FACTURA;1;2;82044;15588;97632
FAC0035722;2015-04-19;CLI00797;FACTURA;28;2;54696;10392;65088
FAC0035723;2015-06-19;CLI00189;FACTURA;17;2;32070;6093;38163
FAC0035724;2015-06-06;CLI00027;FACTURA;5;2;86004;16341;102345
FAC0035725;2015-12-14;CLI00977;FACTURA;45;2;80680;15329;96009
FAC0035726;2015-05-23;CLI00155;FACTURA;14;2;10479;1991;12470
FAC0035727;2015-12-19;CLI00833;FACTURA;31;2;6179;1174;7353
FAC0035728;2015-02-27;CLI00236;FACTURA;39;1;129006;24511;153517
FAC0035729;2015-09-12;CLI00947;FACTURA;44;2;40686;7730;48416
FAC0035730;2015-06-24;CLI00159;FACTURA;7;2;37932;7207;45139
FAC0035731;2015-10-24;CLI00058;FACTURA;40;1;71514;13588;85102
FAC0035732;2015-06-27;CLI00471;FACTURA;49;2;18966;3604;22570
FAC0035733;2015-06-20;CLI00656;FACTURA;16;1;193963;36853;230816
FAC0035734;2015-11-10;CLI00564;FACTURA;2;1;47668;9057;56725
FAC0035735;2015-07-08;CLI00521;FACTURA;18;2;9446;1795;11241
FAC0035736;2015-08-02;CLI00995;FACTURA;33;2;55611;10566;66177
FAC0035737;2015-05-06;CLI00340;FACTURA;4;1;169220;32152;201372
FAC0035738;2015-04-06;CLI00225;FACTURA;35;2;37794;7181;44975
FAC0035739;2015-03-27;CLI00577;FACTURA;18;2;192690;36611;229301
FAC0035740;2015-05-17;CLI00110;FACTURA;9;1;11454;2176;13630
FAC0035741;2015-11-19;CLI00068;FACTURA;2;1;171048;32499;203547
FAC0035742;2015-07-17;CLI00048;FACTURA;8;1;169220;32152;201372
FAC0035743;2015-02-25;CLI00566;FACTURA;21;1;246130;46765;292895
FAC0035744;2015-04-14;CLI00597;FACTURA;9;2;16922;3215;20137
FAC0035745;2015-10-12;CLI00411;FACTURA;33;2;216568;41148;257716
FAC0035746;2015-07-02;CLI00247;FACTURA;25;2;80680;15329;96009
FAC0035747;2015-04-04;CLI00144;FACTURA;48;1;208260;39569;247829
FAC0035748;2015-02-17;CLI00810;FACTURA;35;1;79749;15152;94901
FAC0035749;2015-06-02;CLI00293;FACTURA;18;2;27243;5176;32419
FAC0035750;2015-02-03;CLI00360;FACTURA;8;1;176360;33508;209868
FAC0035751;2015-03-07;CLI00558;FACTURA;14;1;100735;19140;119875
FAC0035752;2015-03-03;CLI00343;FACTURA;10;2;28668;5447;34115
FAC0035753;2015-05-14;CLI00503;FACTURA;17;2;100735;19140;119875
FAC0035754;2015-03-01;CLI00809;FACTURA;49;2;59136;11236;70372
FAC0035755;2015-03-26;CLI00408;FACTURA;41;1;22908;4353;27261
FAC0035756;2015-03-12;CLI00426;FACTURA;5;1;37074;7044;44118
FAC0035757;2015-10-09;CLI00647;FACTURA;32;2;152838;29039;181877
FAC0035758;2015-12-18;CLI00409;FACTURA;18;2;85640;16272;101912
FAC0035759;2015-08-17;CLI00991;FACTURA;34;2;277090;52647;329737
FAC0035760;2015-05-15;CLI00001;FACTURA;45;2;196731;37379;234110
FAC0035761;2015-07-15;CLI00534;FACTURA;11;1;67584;12841;80425
FAC0035762;2015-05-05;CLI00974;FACTURA;35;1;177086;33646;210732
FAC0035763;2015-07-14;CLI00987;FACTURA;26;2;59585;11321;70906
FAC0035764;2015-11-03;CLI00767;FACTURA;2;2;109295;20766;130061
FAC0035765;2015-07-23;CLI00198;FACTURA;45;1;20343;3865;24208
FAC0035766;2015-11-04;CLI00417;FACTURA;3;2;105816;20105;125921
FAC0035767;2015-02-18;CLI00239;FACTURA;48;2;68370;12990;81360
FAC0035768;2015-07-18;CLI00125;FACTURA;9;2;142540;27083;169623
FAC0035769;2015-02-23;CLI00700;FACTURA;37;1;35751;6793;42544
FAC0035770;2015-05-28;CLI00504;FACTURA;22;1;96816;18395;115211
FAC0035771;2015-09-29;CLI00614;FACTURA;7;1;98452;18706;117158
FAC0035772;2015-10-16;CLI00155;FACTURA;46;2;242970;46164;289134
FAC0035773;2015-09-05;CLI00776;FACTURA;12;1;201470;38279;239749
FAC0035774;2015-10-11;CLI00842;FACTURA;7;1;22873;4346;27219
FAC0035775;2015-10-23;CLI00832;FACTURA;12;1;168666;32047;200713
FAC0035776;2015-03-16;CLI00764;FACTURA;9;1;228654;43444;272098
FAC0035777;2015-10-10;CLI00529;FACTURA;27;2;100791;19150;119941
FAC0035778;2015-08-19;CLI00245;FACTURA;33;2;21805;4143;25948
FAC0035779;2015-08-24;CLI00770;FACTURA;11;1;134388;25534;159922
FAC0035780;2015-08-10;CLI00469;FACTURA;12;2;212664;40406;253070
FAC0035781;2015-07-10;CLI00224;FACTURA;13;1;85524;16250;101774
FAC0035782;2015-07-22;CLI00731;FACTURA;28;2;85347;16216;101563
FAC0035783;2015-08-30;CLI00065;FACTURA;11;2;75568;14358;89926
FAC0035784;2015-09-30;CLI00270;FACTURA;25;1;144315;27420;171735
FAC0035785;2015-11-02;CLI00083;FACTURA;40;2;68724;13058;81782
FAC0035786;2015-08-25;CLI00086;FACTURA;2;1;12340;2345;14685
FAC0035787;2015-12-13;CLI00601;FACTURA;38;2;162426;30861;193287
FAC0035788;2015-04-26;CLI00441;FACTURA;29;2;341870;64955;406825
FAC0035789;2015-11-17;CLI00821;FACTURA;7;2;56222;10682;66904
FAC0035790;2015-12-21;CLI00612;FACTURA;32;1;158473;30110;188583
FAC0035791;2015-05-15;CLI00115;FACTURA;13;2;96210;18280;114490
FAC0035792;2015-03-03;CLI00487;FACTURA;31;2;186081;35355;221436
FAC0035793;2015-12-18;CLI00535;FACTURA;1;2;142540;27083;169623
FAC0035794;2015-09-01;CLI00835;FACTURA;13;2;68619;13038;81657
FAC0035795;2015-06-09;CLI00489;FACTURA;9;2;48408;9198;57606
FAC0035796;2015-09-04;CLI00773;FACTURA;35;2;136215;25881;162096
FAC0035797;2015-04-04;CLI00817;FACTURA;9;2;9483;1802;11285
FAC0035798;2015-10-11;CLI00549;FACTURA;22;2;45816;8705;54521
FAC0035799;2015-02-16;CLI00215;FACTURA;43;2;133236;25315;158551
FAC0035800;2015-03-02;CLI00927;FACTURA;16;2;112952;21461;134413
FAC0035801;2015-04-20;CLI00203;FACTURA;49;2;22206;4219;26425
FAC0035802;2015-08-20;CLI00886;FACTURA;47;1;216568;41148;257716
FAC0035803;2015-06-05;CLI00399;FACTURA;9;2;87009;16532;103541
FAC0035804;2015-07-18;CLI00582;FACTURA;2;1;107253;20378;127631
FAC0035805;2015-02-18;CLI00783;FACTURA;45;2;129006;24511;153517
FAC0035806;2015-02-13;CLI00270;FACTURA;32;1;151788;28840;180628
FAC0035807;2015-05-09;CLI00725;FACTURA;43;2;13674;2598;16272
FAC0035808;2015-03-17;CLI00083;FACTURA;6;2;44412;8438;52850
FAC0035809;2015-07-13;CLI00272;FACTURA;20;1;210970;40084;251054
FAC0035810;2015-10-06;CLI00277;FACTURA;47;2;216568;41148;257716
FAC0035811;2015-10-18;CLI00984;FACTURA;8;1;112444;21364;133808
FAC0035812;2015-12-21;CLI00843;FACTURA;14;2;205857;39113;244970
FAC0035813;2015-08-23;CLI00602;FACTURA;3;1;59136;11236;70372
FAC0035814;2015-10-13;CLI00274;FACTURA;45;1;27709;5265;32974
FAC0035815;2015-10-09;CLI00944;FACTURA;40;1;37794;7181;44975
FAC0035816;2015-10-23;CLI00599;FACTURA;1;2;178311;33879;212190
FAC0035817;2015-10-13;CLI00360;FACTURA;10;1;43718;8306;52024
FAC0035818;2015-07-06;CLI00224;FACTURA;27;1;75894;14420;90314
FAC0035819;2015-04-29;CLI00752;FACTURA;49;1;196731;37379;234110
FAC0035820;2015-03-19;CLI00689;FACTURA;4;2;107253;20378;127631
FAC0035821;2015-04-13;CLI00720;FACTURA;3;1;199556;37916;237472
FAC0035822;2015-07-01;CLI00529;FACTURA;4;2;14334;2723;17057
FAC0035823;2015-12-29;CLI00132;FACTURA;12;1;58006;11021;69027
FAC0035824;2015-10-30;CLI00220;FACTURA;39;1;196904;37412;234316
FAC0035825;2015-08-18;CLI00077;FACTURA;26;2;9483;1802;11285
FAC0035826;2015-08-08;CLI00197;FACTURA;10;2;139216;26451;165667
FAC0035827;2015-08-05;CLI00930;FACTURA;27;1;141029;26796;167825
FAC0035828;2015-07-21;CLI00192;FACTURA;35;1;290030;55106;345136
FAC0035829;2015-10-20;CLI00406;FACTURA;38;1;228654;43444;272098
FAC0035830;2015-07-05;CLI00029;FACTURA;10;2;64140;12187;76327
FAC0035831;2015-06-13;CLI00477;FACTURA;9;2;18510;3517;22027
FAC0035832;2015-08-08;CLI00709;FACTURA;39;2;100791;19150;119941
FAC0035833;2015-05-09;CLI00936;FACTURA;14;1;67584;12841;80425
FAC0035834;2015-03-17;CLI00221;FACTURA;41;2;84480;16051;100531
FAC0035835;2015-04-10;CLI00119;FACTURA;35;2;201582;38301;239883
FAC0035836;2015-08-03;CLI00966;FACTURA;19;1;195060;37061;232121
FAC0035837;2015-05-14;CLI00414;FACTURA;10;1;64544;12263;76807
FAC0035838;2015-01-11;CLI00696;FACTURA;34;1;111030;21096;132126
FAC0035839;2015-12-17;CLI00117;FACTURA;16;2;24668;4687;29355
FAC0035840;2015-02-16;CLI00926;FACTURA;14;1;88824;16877;105701
FAC0035841;2015-06-19;CLI00973;FACTURA;14;2;50766;9646;60412
FAC0035842;2015-10-18;CLI00628;FACTURA;30;1;203248;38617;241865
FAC0035843;2015-05-08;CLI00788;FACTURA;38;1;19506;3706;23212
FAC0035844;2015-04-04;CLI00163;FACTURA;25;2;161360;30658;192018
FAC0035845;2015-06-16;CLI00733;FACTURA;32;2;43253;8218;51471
FAC0035846;2015-11-27;CLI00684;FACTURA;11;1;87436;16613;104049
FAC0035847;2015-11-14;CLI00077;FACTURA;27;2;19506;3706;23212
FAC0035848;2015-06-01;CLI00843;FACTURA;33;2;109295;20766;130061
FAC0035849;2015-03-17;CLI00613;FACTURA;27;2;168666;32047;200713
FAC0035850;2015-05-21;CLI00335;FACTURA;12;2;174020;33064;207084
FAC0035851;2015-03-29;CLI00839;FACTURA;31;2;227682;43260;270942
FAC0035852;2015-06-12;CLI00561;FACTURA;7;2;87436;16613;104049
FAC0035853;2015-12-05;CLI00294;FACTURA;29;1;47668;9057;56725
FAC0035854;2015-07-26;CLI00034;FACTURA;15;1;341870;64955;406825
FAC0035855;2015-06-25;CLI00070;FACTURA;14;1;50596;9613;60209
FAC0035856;2015-08-29;CLI00853;FACTURA;33;2;56691;10771;67462
FAC0035857;2015-08-10;CLI00697;FACTURA;35;2;102561;19487;122048
FAC0035858;2015-12-10;CLI00652;FACTURA;19;1;56380;10712;67092
FAC0035859;2015-07-12;CLI00652;FACTURA;21;1;101532;19291;120823
FAC0035860;2015-05-02;CLI00132;FACTURA;43;1;83127;15794;98921
FAC0035861;2015-01-03;CLI00401;FACTURA;31;2;7946;1510;9456
FAC0035862;2015-02-18;CLI00811;FACTURA;7;2;107050;20340;127390
FAC0035863;2015-01-21;CLI00516;FACTURA;35;1;196777;37388;234165
FAC0035864;2015-11-18;CLI00050;FACTURA;34;1;173550;32975;206525
FAC0035865;2015-06-27;CLI00502;FACTURA;49;1;203751;38713;242464
FAC0035866;2015-11-20;CLI00810;FACTURA;19;1;86004;16341;102345
FAC0035867;2015-03-29;CLI00235;FACTURA;29;2;60876;11566;72442
FAC0035868;2015-07-22;CLI00863;FACTURA;29;2;178311;33879;212190
FAC0035869;2015-08-23;CLI00875;FACTURA;9;2;80588;15312;95900
FAC0035870;2015-12-12;CLI00704;FACTURA;36;1;104130;19785;123915
FAC0035871;2015-01-14;CLI00993;FACTURA;22;2;43002;8170;51172
FAC0035872;2015-10-19;CLI00752;FACTURA;6;1;142540;27083;169623
FAC0035873;2015-05-30;CLI00885;FACTURA;42;2;226390;43014;269404
FAC0035874;2015-07-14;CLI00435;FACTURA;30;2;52908;10053;62961
FAC0035875;2015-06-24;CLI00942;FACTURA;49;1;302373;57451;359824
FAC0035876;2015-02-12;CLI00168;FACTURA;19;1;100735;19140;119875
FAC0035877;2015-09-05;CLI00869;FACTURA;29;2;60876;11566;72442
FAC0035878;2015-02-20;CLI00925;FACTURA;3;2;126490;24033;150523
FAC0035879;2015-11-23;CLI00763;FACTURA;7;2;277680;52759;330439
FAC0035880;2015-04-18;CLI00420;FACTURA;46;1;123452;23456;146908
FAC0035881;2015-09-08;CLI00640;FACTURA;50;1;60441;11484;71925
FAC0035882;2015-03-17;CLI00461;FACTURA;1;2;168666;32047;200713
FAC0035883;2015-05-21;CLI00311;FACTURA;41;2;88180;16754;104934
FAC0035884;2015-02-09;CLI00059;FACTURA;44;2;222060;42191;264251
FAC0035885;2015-03-16;CLI00858;FACTURA;4;1;21117;4012;25129
FAC0035886;2015-02-11;CLI00576;FACTURA;16;1;176360;33508;209868
FAC0035887;2015-12-12;CLI00981;FACTURA;11;2;51005;9691;60696
FAC0035888;2015-07-06;CLI00829;FACTURA;3;2;199556;37916;237472
FAC0035889;2015-07-29;CLI00299;FACTURA;47;2;7946;1510;9456
FAC0035890;2015-12-23;CLI00228;FACTURA;46;1;181112;34411;215523
FAC0035891;2015-07-28;CLI00125;FACTURA;16;2;33844;6430;40274
FAC0035892;2015-10-22;CLI00048;FACTURA;10;1;85014;16153;101167
FAC0035893;2015-01-24;CLI00031;FACTURA;6;2;67584;12841;80425
FAC0035894;2015-10-19;CLI00033;FACTURA;5;2;229362;43579;272941
FAC0035895;2015-10-01;CLI00634;FACTURA;41;1;18537;3522;22059
FAC0035896;2015-04-27;CLI00711;FACTURA;32;2;116012;22042;138054
FAC0035897;2015-11-23;CLI00926;FACTURA;44;1;221517;42088;263605
FAC0035898;2015-06-04;CLI00290;FACTURA;47;1;243628;46289;289917
FAC0035899;2015-08-28;CLI00684;FACTURA;29;1;87009;16532;103541
FAC0035900;2015-08-15;CLI00948;FACTURA;28;1;178311;33879;212190
FAC0035901;2015-10-08;CLI00774;FACTURA;25;1;82044;15588;97632
FAC0035902;2015-06-26;CLI00385;FACTURA;40;2;83127;15794;98921
FAC0035903;2015-09-30;CLI00519;FACTURA;34;2;114032;21666;135698
FAC0035904;2015-10-01;CLI00218;FACTURA;7;1;88180;16754;104934
FAC0035905;2015-04-25;CLI00463;FACTURA;29;2;239247;45457;284704
FAC0035906;2015-07-30;CLI00876;FACTURA;37;1;27071;5143;32214
FAC0035907;2015-05-18;CLI00710;FACTURA;27;1;8448;1605;10053
FAC0035908;2015-05-12;CLI00704;FACTURA;26;1;152635;29001;181636
FAC0035909;2015-07-05;CLI00884;FACTURA;38;1;75864;14414;90278
FAC0035910;2015-05-12;CLI00616;FACTURA;22;1;20958;3982;24940
FAC0035911;2015-09-17;CLI00663;FACTURA;23;2;18510;3517;22027
FAC0035912;2015-07-15;CLI00766;FACTURA;29;1;268776;51067;319843
FAC0035913;2015-12-10;CLI00437;FACTURA;35;2;85347;16216;101563
FAC0035914;2015-07-16;CLI00935;FACTURA;11;2;81372;15461;96833
FAC0035915;2015-10-28;CLI00862;FACTURA;48;1;80680;15329;96009
FAC0035916;2015-08-22;CLI00969;FACTURA;43;2;96816;18395;115211
FAC0035917;2015-03-09;CLI00006;FACTURA;37;1;21117;4012;25129
FAC0035918;2015-05-26;CLI00587;FACTURA;3;2;83127;15794;98921
FAC0035919;2015-11-18;CLI00538;FACTURA;14;1;58518;11118;69636
FAC0035920;2015-07-08;CLI00724;FACTURA;47;1;22873;4346;27219
FAC0035921;2015-04-25;CLI00663;FACTURA;21;2;85524;16250;101774
FAC0035922;2015-05-19;CLI00902;FACTURA;13;1;21117;4012;25129
FAC0035923;2015-09-01;CLI00035;FACTURA;45;2;40804;7753;48557
FAC0035924;2015-08-01;CLI00133;FACTURA;18;2;226390;43014;269404
FAC0035925;2015-01-22;CLI00903;FACTURA;10;2;16922;3215;20137
FAC0035926;2015-12-09;CLI00267;FACTURA;3;2;91632;17410;109042
FAC0035927;2015-04-06;CLI00188;FACTURA;9;1;254730;48399;303129
FAC0035928;2015-10-18;CLI00556;FACTURA;1;1;203248;38617;241865
FAC0035929;2015-06-04;CLI00756;FACTURA;15;1;71502;13585;85087
FAC0035930;2015-01-03;CLI00689;FACTURA;21;2;156048;29649;185697
FAC0035931;2015-01-03;CLI00317;FACTURA;38;2;56222;10682;66904
FAC0035932;2015-08-02;CLI00847;FACTURA;43;2;177648;33753;211401
FAC0035933;2015-08-14;CLI00971;FACTURA;42;2;18892;3589;22481
FAC0035934;2015-04-11;CLI00895;FACTURA;15;2;33597;6383;39980
FAC0035935;2015-06-23;CLI00094;FACTURA;9;1;18510;3517;22027
FAC0035936;2015-08-19;CLI00923;FACTURA;26;2;64140;12187;76327
FAC0035937;2015-12-01;CLI00447;FACTURA;20;2;172676;32808;205484
FAC0035938;2015-02-09;CLI00663;FACTURA;45;2;64230;12204;76434
FAC0035939;2015-07-12;CLI00723;FACTURA;17;2;112444;21364;133808
FAC0035940;2015-03-04;CLI00369;FACTURA;44;2;347100;65949;413049
FAC0035941;2015-09-29;CLI00575;FACTURA;31;2;10479;1991;12470
FAC0035942;2015-07-10;CLI00098;FACTURA;20;1;170935;32478;203413
FAC0035943;2015-12-03;CLI00424;FACTURA;16;1;265830;50508;316338
FAC0035944;2015-01-23;CLI00901;FACTURA;39;2;12358;2348;14706
FAC0035945;2015-01-26;CLI00717;FACTURA;12;2;61790;11740;73530
FAC0035946;2015-04-28;CLI00247;FACTURA;50;2;123065;23382;146447
FAC0035947;2015-06-16;CLI00921;FACTURA;22;2;96816;18395;115211
FAC0035948;2015-04-09;CLI00135;FACTURA;37;2;131154;24919;156073
FAC0035949;2015-06-12;CLI00834;FACTURA;28;1;68374;12991;81365
FAC0035950;2015-11-11;CLI00939;FACTURA;45;2;48408;9198;57606
FAC0035951;2015-10-24;CLI00727;FACTURA;42;2;22873;4346;27219
FAC0035952;2015-06-02;CLI00364;FACTURA;37;1;80680;15329;96009
FAC0035953;2015-11-02;CLI00236;FACTURA;15;1;218590;41532;260122
FAC0035954;2015-10-28;CLI00789;FACTURA;48;2;40686;7730;48416
FAC0035955;2015-05-30;CLI00304;FACTURA;9;1;313236;59515;372751
FAC0035956;2015-05-02;CLI00245;FACTURA;49;2;60441;11484;71925
FAC0035957;2015-07-14;CLI00325;FACTURA;42;2;222060;42191;264251
FAC0035958;2015-12-21;CLI00765;FACTURA;47;2;21117;4012;25129
FAC0035959;2015-07-31;CLI00235;FACTURA;49;2;172291;32735;205026
FAC0035960;2015-11-22;CLI00686;FACTURA;13;1;104412;19838;124250
FAC0035961;2015-06-20;CLI00464;FACTURA;15;1;195060;37061;232121
FAC0035962;2015-10-03;CLI00868;FACTURA;40;1;168936;32098;201034
FAC0035963;2015-08-01;CLI00535;FACTURA;1;2;25473;4840;30313
FAC0035964;2015-01-29;CLI00302;FACTURA;43;1;61700;11723;73423
FAC0035965;2015-11-19;CLI00342;FACTURA;13;1;177648;33753;211401
FAC0035966;2015-07-04;CLI00050;FACTURA;17;1;87009;16532;103541
FAC0035967;2015-01-26;CLI00626;FACTURA;12;1;126490;24033;150523
FAC0035968;2015-04-29;CLI00011;FACTURA;43;2;91809;17444;109253
FAC0035969;2015-01-26;CLI00579;FACTURA;15;2;18897;3590;22487
FAC0035970;2015-12-22;CLI00900;FACTURA;47;1;5638;1071;6709
FAC0035971;2015-10-10;CLI00046;FACTURA;47;1;13674;2598;16272
FAC0035972;2015-02-17;CLI00320;FACTURA;4;1;201470;38279;239749
FAC0035973;2015-03-21;CLI00326;FACTURA;8;1;100791;19150;119941
FAC0035974;2015-12-08;CLI00720;FACTURA;21;1;183087;34787;217874
FAC0035975;2015-06-05;CLI00107;FACTURA;9;2;71514;13588;85102
FAC0035976;2015-05-27;CLI00533;FACTURA;12;2;55622;10568;66190
FAC0035977;2015-06-24;CLI00031;FACTURA;4;2;54696;10392;65088
FAC0035978;2015-07-07;CLI00868;FACTURA;32;1;34362;6529;40891
FAC0035979;2015-09-08;CLI00250;FACTURA;10;1;65415;12429;77844
FAC0035980;2015-07-04;CLI00280;FACTURA;31;1;37020;7034;44054
FAC0035981;2015-06-17;CLI00654;FACTURA;43;1;35751;6793;42544
FAC0035982;2015-09-22;CLI00980;FACTURA;2;1;151788;28840;180628
FAC0035983;2015-11-12;CLI00110;FACTURA;1;1;136748;25982;162730
FAC0035984;2015-06-01;CLI00448;FACTURA;35;1;109025;20715;129740
FAC0035985;2015-09-30;CLI00826;FACTURA;1;1;162426;30861;193287
FAC0035986;2015-10-16;CLI00863;FACTURA;24;2;205857;39113;244970
FAC0035987;2015-08-05;CLI00089;FACTURA;48;2;105485;20042;125527
FAC0035988;2015-12-17;CLI00306;FACTURA;1;1;84610;16076;100686
FAC0035989;2015-10-04;CLI00965;FACTURA;17;2;64230;12204;76434
FAC0035990;2015-10-29;CLI00493;FACTURA;48;2;24680;4689;29369
FAC0035991;2015-07-17;CLI00725;FACTURA;37;2;43190;8206;51396
FAC0035992;2015-01-25;CLI00008;FACTURA;31;1;76032;14446;90478
FAC0035993;2015-12-27;CLI00584;FACTURA;7;1;130830;24858;155688
FAC0035994;2015-01-17;CLI00226;FACTURA;45;1;205857;39113;244970
FAC0035995;2015-09-18;CLI00608;FACTURA;35;1;18966;3604;22570
FAC0035996;2015-08-03;CLI00615;FACTURA;9;2;175554;33355;208909
FAC0035997;2015-03-03;CLI00443;FACTURA;47;2;147819;28086;175905
FAC0035998;2015-04-06;CLI00076;FACTURA;17;1;132279;25133;157412
FAC0035999;2015-11-21;CLI00701;FACTURA;12;2;39466;7499;46965
FAC0036000;2015-02-14;CLI00551;FACTURA;10;2;302373;57451;359824
FAC0036001;2015-07-25;CLI00423;FACTURA;12;2;47676;9058;56734
FAC0036002;2015-09-13;CLI00262;FACTURA;46;1;51005;9691;60696
FAC0036003;2015-12-26;CLI00717;FACTURA;19;2;23838;4529;28367
FAC0036004;2015-05-15;CLI00725;FACTURA;8;2;183087;34787;217874
FAC0036005;2015-12-19;CLI00380;FACTURA;50;1;227682;43260;270942
FAC0036006;2015-07-25;CLI00080;FACTURA;4;1;141088;26807;167895
FAC0036007;2015-05-06;CLI00105;FACTURA;22;2;100791;19150;119941
FAC0036008;2015-11-23;CLI00910;FACTURA;33;1;50812;9654;60466
FAC0036009;2015-12-28;CLI00825;FACTURA;31;2;228654;43444;272098
FAC0036010;2015-01-14;CLI00080;FACTURA;45;1;152635;29001;181636
FAC0036011;2015-01-19;CLI00307;FACTURA;47;2;30603;5815;36418
FAC0036012;2015-02-06;CLI00793;FACTURA;38;2;193963;36853;230816
FAC0036013;2015-01-08;CLI00500;FACTURA;9;1;149870;28475;178345
FAC0036014;2015-07-03;CLI00058;FACTURA;1;1;69420;13190;82610
FAC0036015;2015-04-05;CLI00123;FACTURA;29;2;78024;14825;92849
FAC0036016;2015-06-27;CLI00164;FACTURA;18;1;28111;5341;33452
FAC0036017;2015-04-23;CLI00826;FACTURA;12;1;152838;29039;181877
FAC0036018;2015-02-24;CLI00611;FACTURA;7;2;122058;23191;145249
FAC0036019;2015-02-06;CLI00419;FACTURA;22;2;39012;7412;46424
FAC0036020;2015-11-16;CLI00873;FACTURA;6;2;190053;36110;226163
FAC0036021;2015-05-05;CLI00221;FACTURA;10;2;192690;36611;229301
FAC0036022;2015-10-19;CLI00529;FACTURA;39;2;43002;8170;51172
FAC0036023;2015-10-02;CLI00942;FACTURA;40;1;18510;3517;22027
FAC0036024;2015-04-17;CLI00518;FACTURA;1;1;33844;6430;40274
FAC0036025;2015-10-04;CLI00593;FACTURA;38;2;105485;20042;125527
FAC0036026;2015-06-07;CLI00841;FACTURA;23;2;49226;9353;58579
FAC0036027;2015-02-21;CLI00236;FACTURA;47;1;56676;10768;67444
FAC0036028;2015-09-03;CLI00383;FACTURA;41;2;152298;28937;181235
FAC0036029;2015-07-08;CLI00219;FACTURA;13;2;195060;37061;232121
FAC0036030;2015-02-15;CLI00355;FACTURA;18;2;285080;54165;339245
FAC0036031;2015-03-30;CLI00377;FACTURA;28;2;40686;7730;48416
FAC0036032;2015-09-07;CLI00911;FACTURA;4;2;68724;13058;81782
FAC0036033;2015-05-31;CLI00540;FACTURA;23;1;163458;31057;194515
FAC0036034;2015-05-17;CLI00639;FACTURA;27;2;75864;14414;90278
FAC0036035;2015-12-01;CLI00906;FACTURA;27;1;120882;22968;143850
FAC0036036;2015-08-19;CLI00408;FACTURA;7;1;33844;6430;40274
FAC0036037;2015-06-13;CLI00713;FACTURA;34;2;39466;7499;46965
FAC0036038;2015-12-05;CLI00823;FACTURA;8;2;126702;24073;150775
FAC0036039;2015-06-18;CLI00785;FACTURA;41;2;152635;29001;181636
FAC0036040;2015-01-12;CLI00697;FACTURA;49;2;173550;32975;206525
FAC0036041;2015-08-09;CLI00762;FACTURA;39;1;33597;6383;39980
FAC0036042;2015-12-18;CLI00766;FACTURA;16;1;265830;50508;316338
FAC0036043;2015-10-30;CLI00700;FACTURA;9;1;144315;27420;171735
FAC0036044;2015-07-10;CLI00863;FACTURA;17;2;58518;11118;69636
FAC0036045;2015-04-12;CLI00367;FACTURA;28;2;27243;5176;32419
FAC0036046;2015-05-19;CLI00915;FACTURA;13;2;116012;22042;138054
FAC0036047;2015-09-09;CLI00830;FACTURA;18;1;49360;9378;58738
FAC0036048;2015-06-14;CLI00848;FACTURA;6;1;193963;36853;230816
FAC0036049;2015-12-31;CLI00593;FACTURA;18;2;307683;58460;366143
FAC0036050;2015-06-30;CLI00367;FACTURA;32;2;40584;7711;48295
FAC0036051;2015-11-16;CLI00814;FACTURA;44;1;290030;55106;345136
FAC0036052;2015-06-16;CLI00822;FACTURA;24;1;132279;25133;157412
FAC0036053;2015-04-14;CLI00538;FACTURA;1;1;142540;27083;169623
FAC0036054;2015-04-06;CLI00377;FACTURA;37;2;15892;3019;18911
FAC0036055;2015-05-20;CLI00095;FACTURA;31;2;203021;38574;241595
FAC0036056;2015-11-05;CLI00028;FACTURA;24;1;107050;20340;127390
FAC0036057;2015-11-07;CLI00416;FACTURA;15;1;256572;48749;305321
FAC0036058;2015-05-01;CLI00341;FACTURA;47;2;239309;45469;284778
FAC0036059;2015-05-04;CLI00047;FACTURA;49;2;32766;6226;38992
FAC0036060;2015-09-27;CLI00758;FACTURA;31;1;128460;24407;152867
FAC0036061;2015-02-11;CLI00423;FACTURA;9;2;221517;42088;263605
FAC0036062;2015-03-22;CLI00991;FACTURA;16;2;63351;12037;75388
FAC0036063;2015-06-07;CLI00852;FACTURA;4;1;142401;27056;169457
FAC0036064;2015-02-05;CLI00253;FACTURA;42;2;22873;4346;27219
FAC0036065;2015-05-02;CLI00788;FACTURA;45;1;196904;37412;234316
FAC0036066;2015-09-05;CLI00105;FACTURA;17;2;33597;6383;39980
FAC0036067;2015-05-05;CLI00312;FACTURA;11;1;63351;12037;75388
FAC0036068;2015-09-14;CLI00551;FACTURA;48;2;33792;6420;40212
FAC0036069;2015-07-31;CLI00760;FACTURA;9;1;55418;10529;65947
FAC0036070;2015-03-09;CLI00383;FACTURA;33;2;9483;1802;11285
FAC0036071;2015-07-09;CLI00188;FACTURA;25;1;171280;32543;203823
FAC0036072;2015-01-08;CLI00223;FACTURA;41;2;109025;20715;129740
FAC0036073;2015-10-29;CLI00178;FACTURA;50;1;65532;12451;77983
FAC0036074;2015-06-18;CLI00819;FACTURA;49;2;110836;21059;131895
FAC0036075;2015-10-23;CLI00721;FACTURA;4;2;24668;4687;29355
FAC0036076;2015-02-02;CLI00782;FACTURA;14;1;61700;11723;73423
FAC0036077;2015-06-08;CLI00152;FACTURA;20;1;76218;14481;90699
FAC0036078;2015-06-26;CLI00778;FACTURA;40;1;50766;9646;60412
FAC0036079;2015-10-27;CLI00394;FACTURA;5;1;61029;11596;72625
FAC0036080;2015-01-29;CLI00874;FACTURA;5;1;168666;32047;200713
FAC0036081;2015-03-08;CLI00712;FACTURA;3;1;100338;19064;119402
FAC0036082;2015-10-27;CLI00618;FACTURA;28;1;114672;21788;136460
FAC0036083;2015-03-25;CLI00954;FACTURA;13;1;69608;13226;82834
FAC0036084;2015-04-06;CLI00832;FACTURA;24;1;307683;58460;366143
FAC0036085;2015-11-04;CLI00194;FACTURA;5;1;153013;29072;182085
FAC0036086;2015-01-28;CLI00034;FACTURA;12;1;126582;24051;150633
FAC0036087;2015-11-15;CLI00543;FACTURA;28;2;196596;37353;233949
FAC0036088;2015-02-05;CLI00699;FACTURA;42;2;91314;17350;108664
FAC0036089;2015-06-25;CLI00770;FACTURA;32;1;20958;3982;24940
FAC0036090;2015-10-25;CLI00620;FACTURA;7;1;51005;9691;60696
FAC0036091;2015-01-09;CLI00877;FACTURA;27;2;114672;21788;136460
FAC0036092;2015-11-26;CLI00463;FACTURA;15;2;28111;5341;33452
FAC0036093;2015-03-01;CLI00514;FACTURA;22;1;14334;2723;17057
FAC0036094;2015-08-16;CLI00516;FACTURA;27;1;29003;5511;34514
FAC0036095;2015-05-14;CLI00557;FACTURA;19;2;94830;18018;112848
FAC0036096;2015-09-21;CLI00889;FACTURA;25;2;138545;26324;164869
FAC0036097;2015-12-07;CLI00743;FACTURA;10;2;18510;3517;22027
FAC0036098;2015-09-26;CLI00639;FACTURA;48;2;66122;12563;78685
FAC0036099;2015-10-15;CLI00998;FACTURA;17;1;71670;13617;85287
FAC0036100;2015-05-26;CLI00501;FACTURA;33;2;23838;4529;28367
FAC0036101;2015-12-03;CLI00861;FACTURA;3;2;160111;30421;190532
FAC0036102;2015-03-26;CLI00126;FACTURA;40;1;68724;13058;81782
FAC0036103;2015-05-17;CLI00880;FACTURA;14;1;87009;16532;103541
FAC0036104;2015-08-01;CLI00826;FACTURA;39;1;22206;4219;26425
FAC0036105;2015-01-23;CLI00362;FACTURA;12;1;28338;5384;33722
FAC0036106;2015-03-14;CLI00472;FACTURA;34;1;66122;12563;78685
FAC0036107;2015-01-23;CLI00717;FACTURA;50;2;76032;14446;90478
FAC0036108;2015-06-10;CLI00344;FACTURA;40;1;135376;25721;161097
FAC0036109;2015-03-25;CLI00953;FACTURA;11;2;75588;14362;89950
FAC0036110;2015-09-06;CLI00676;FACTURA;1;1;42820;8136;50956
FAC0036111;2015-04-01;CLI00638;FACTURA;40;1;68374;12991;81365
FAC0036112;2015-09-27;CLI00746;FACTURA;24;1;134388;25534;159922
FAC0036113;2015-05-30;CLI00815;FACTURA;50;2;56222;10682;66904
FAC0036114;2015-06-19;CLI00318;FACTURA;17;1;160350;30467;190817
FAC0036115;2015-07-31;CLI00940;FACTURA;36;1;181323;34451;215774
FAC0036116;2015-01-21;CLI00039;FACTURA;45;2;202384;38453;240837
FAC0036117;2015-03-21;CLI00552;FACTURA;16;1;94460;17947;112407
FAC0036118;2015-04-15;CLI00768;FACTURA;30;1;64230;12204;76434
FAC0036119;2015-09-11;CLI00717;FACTURA;28;2;131064;24902;155966
FAC0036120;2015-08-26;CLI00018;FACTURA;39;1;142401;27056;169457
FAC0036121;2015-10-14;CLI00637;FACTURA;26;2;302373;57451;359824
FAC0036122;2015-10-19;CLI00813;FACTURA;35;2;76032;14446;90478
FAC0036123;2015-10-17;CLI00229;FACTURA;22;2;55622;10568;66190
FAC0036124;2015-08-10;CLI00951;FACTURA;20;2;18892;3589;22481
FAC0036125;2015-05-10;CLI00984;FACTURA;21;1;109392;20784;130176
FAC0036126;2015-12-19;CLI00590;FACTURA;33;1;21805;4143;25948
FAC0036127;2015-02-08;CLI00138;FACTURA;6;1;63291;12025;75316
FAC0036128;2015-07-26;CLI00836;FACTURA;44;1;201582;38301;239883
FAC0036129;2015-10-11;CLI00119;FACTURA;33;2;181323;34451;215774
FAC0036130;2015-01-27;CLI00134;FACTURA;5;1;155442;29534;184976
FAC0036131;2015-10-21;CLI00568;FACTURA;48;1;228064;43332;271396
FAC0036132;2015-09-16;CLI00019;FACTURA;42;2;151788;28840;180628
FAC0036133;2015-03-04;CLI00361;FACTURA;1;2;74004;14061;88065
FAC0036134;2015-12-29;CLI00789;FACTURA;36;2;52908;10053;62961
FAC0036135;2015-12-13;CLI00126;FACTURA;26;1;50946;9680;60626
FAC0036136;2015-01-06;CLI00112;FACTURA;13;1;129006;24511;153517
FAC0036137;2015-11-25;CLI00458;FACTURA;46;1;101892;19359;121251
FAC0036138;2015-08-27;CLI00172;FACTURA;48;1;28508;5417;33925
FAC0036139;2015-11-21;CLI00640;FACTURA;30;1;40804;7753;48557
FAC0036140;2015-11-03;CLI00081;FACTURA;46;2;190701;36233;226934
FAC0036141;2015-02-07;CLI00372;FACTURA;21;1;118454;22506;140960
FAC0036142;2015-02-13;CLI00550;FACTURA;20;1;71502;13585;85087
FAC0036143;2015-09-09;CLI00147;FACTURA;15;2;54486;10352;64838
FAC0036144;2015-06-08;CLI00246;FACTURA;9;1;49336;9374;58710
FAC0036145;2015-08-26;CLI00115;FACTURA;15;2;60876;11566;72442
FAC0036146;2015-07-21;CLI00705;FACTURA;29;2;107253;20378;127631
FAC0036147;2015-06-22;CLI00187;FACTURA;8;2;131154;24919;156073
FAC0036148;2015-06-19;CLI00410;FACTURA;39;1;249381;47382;296763
FAC0036149;2015-01-17;CLI00796;FACTURA;3;1;28508;5417;33925
FAC0036150;2015-10-15;CLI00538;FACTURA;45;1;45104;8570;53674
FAC0036151;2015-04-03;CLI00827;FACTURA;5;2;130830;24858;155688
FAC0036152;2015-02-15;CLI00633;FACTURA;42;2;10479;1991;12470
FAC0036153;2015-12-29;CLI00726;FACTURA;35;1;265830;50508;316338
FAC0036154;2015-09-19;CLI00337;FACTURA;46;2;147679;28059;175738
FAC0036155;2015-01-21;CLI00274;FACTURA;34;1;20343;3865;24208
FAC0036156;2015-05-17;CLI00201;FACTURA;26;2;136740;25981;162721
FAC0036157;2015-03-03;CLI00502;FACTURA;23;1;265830;50508;316338
FAC0036158;2015-06-19;CLI00727;FACTURA;4;2;30603;5815;36418
FAC0036159;2015-01-25;CLI00827;FACTURA;23;2;71022;13494;84516
FAC0036160;2015-08-21;CLI00922;FACTURA;7;1;42234;8024;50258
FAC0036161;2015-05-27;CLI00535;FACTURA;41;2;42194;8017;50211
FAC0036162;2015-06-18;CLI00962;FACTURA;14;1;168776;32067;200843
FAC0036163;2015-04-28;CLI00054;FACTURA;38;1;162744;30921;193665
FAC0036164;2015-03-24;CLI00450;FACTURA;28;1;31437;5973;37410
FAC0036165;2015-11-19;CLI00630;FACTURA;10;1;174440;33144;207584
FAC0036166;2015-11-07;CLI00707;FACTURA;48;2;67688;12861;80549
FAC0036167;2015-11-28;CLI00060;FACTURA;6;1;47668;9057;56725
FAC0036168;2015-09-18;CLI00588;FACTURA;40;1;227682;43260;270942
FAC0036169;2015-01-15;CLI00831;FACTURA;44;2;122058;23191;145249
FAC0036170;2015-10-23;CLI00086;FACTURA;25;1;20292;3855;24147
FAC0036171;2015-07-20;CLI00917;FACTURA;15;2;136215;25881;162096
FAC0036172;2015-05-09;CLI00319;FACTURA;10;2;327660;62255;389915
FAC0036173;2015-10-24;CLI00990;FACTURA;10;1;71514;13588;85102
FAC0036174;2015-01-16;CLI00639;FACTURA;41;2;16922;3215;20137
FAC0036175;2015-03-25;CLI00556;FACTURA;24;1;25473;4840;30313
FAC0036176;2015-04-27;CLI00083;FACTURA;19;2;28508;5417;33925
FAC0036177;2015-07-03;CLI00074;FACTURA;36;1;24680;4689;29369
FAC0036178;2015-02-20;CLI00532;FACTURA;1;1;131154;24919;156073
FAC0036179;2015-09-26;CLI00956;FACTURA;20;1;95336;18114;113450
FAC0036180;2015-11-18;CLI00802;FACTURA;8;1;33844;6430;40274
FAC0036181;2015-02-26;CLI00593;FACTURA;43;2;78024;14825;92849
FAC0036182;2015-07-21;CLI00764;FACTURA;48;1;41022;7794;48816
FAC0036183;2015-11-23;CLI00256;FACTURA;32;1;11917;2264;14181
FAC0036184;2015-04-01;CLI00528;FACTURA;11;1;272430;51762;324192
FAC0036185;2015-04-19;CLI00807;FACTURA;49;2;139216;26451;165667
FAC0036186;2015-09-08;CLI00779;FACTURA;16;2;27709;5265;32974
FAC0036187;2015-12-15;CLI00825;FACTURA;34;2;135376;25721;161097
FAC0036188;2015-12-13;CLI00279;FACTURA;9;2;208260;39569;247829
FAC0036189;2015-08-06;CLI00039;FACTURA;47;2;42240;8026;50266
FAC0036190;2015-05-08;CLI00383;FACTURA;10;2;79460;15097;94557
FAC0036191;2015-08-26;CLI00173;FACTURA;12;2;174018;33063;207081
FAC0036192;2015-06-21;CLI00683;FACTURA;50;2;65415;12429;77844
FAC0036193;2015-02-01;CLI00973;FACTURA;7;2;203248;38617;241865
FAC0036194;2015-07-30;CLI00771;FACTURA;30;2;246130;46765;292895
FAC0036195;2015-12-31;CLI00255;FACTURA;26;2;51005;9691;60696
FAC0036196;2015-03-20;CLI00976;FACTURA;41;1;56898;10811;67709
FAC0036197;2015-09-11;CLI00393;FACTURA;15;2;126702;24073;150775
FAC0036198;2015-01-20;CLI00322;FACTURA;49;1;114032;21666;135698
FAC0036199;2015-05-06;CLI00381;FACTURA;29;2;75588;14362;89950
FAC0036200;2015-07-27;CLI00752;FACTURA;8;1;80680;15329;96009
FAC0036201;2015-04-18;CLI00451;FACTURA;9;2;16035;3047;19082
FAC0036202;2015-03-06;CLI00639;FACTURA;21;2;78024;14825;92849
FAC0036203;2015-04-24;CLI00123;FACTURA;15;2;56676;10768;67444
FAC0036204;2015-10-27;CLI00948;FACTURA;17;1;133236;25315;158551
FAC0036205;2015-07-15;CLI00947;FACTURA;26;2;201582;38301;239883
FAC0036206;2015-04-10;CLI00555;FACTURA;31;2;12358;2348;14706
FAC0036207;2015-08-12;CLI00687;FACTURA;6;2;252999;48070;301069
FAC0036208;2015-12-23;CLI00486;FACTURA;9;1;127365;24199;151564
FAC0036209;2015-04-21;CLI00196;FACTURA;4;1;243639;46291;289930
FAC0036210;2015-02-18;CLI00427;FACTURA;25;2;27071;5143;32214
FAC0036211;2015-10-11;CLI00945;FACTURA;25;2;195060;37061;232121
FAC0036212;2015-07-22;CLI00452;FACTURA;28;1;18537;3522;22059
FAC0036213;2015-02-12;CLI00443;FACTURA;26;2;221672;42118;263790
FAC0036214;2015-07-29;CLI00270;FACTURA;48;1;76032;14446;90478
FAC0036215;2015-06-02;CLI00032;FACTURA;23;1;11276;2142;13418
FAC0036216;2015-10-30;CLI00603;FACTURA;49;2;48105;9140;57245
FAC0036217;2015-08-14;CLI00177;FACTURA;35;2;24668;4687;29355
FAC0036218;2015-03-31;CLI00003;FACTURA;29;2;74004;14061;88065
FAC0036219;2015-11-12;CLI00145;FACTURA;28;2;307683;58460;366143
FAC0036220;2015-08-21;CLI00855;FACTURA;19;2;71022;13494;84516
FAC0036221;2015-08-14;CLI00116;FACTURA;7;1;91314;17350;108664
FAC0036222;2015-07-31;CLI00722;FACTURA;47;1;54696;10392;65088
FAC0036223;2015-03-12;CLI00248;FACTURA;13;1;147819;28086;175905
FAC0036224;2015-03-23;CLI00846;FACTURA;33;1;57336;10894;68230
FAC0036225;2015-11-16;CLI00929;FACTURA;47;2;129006;24511;153517
FAC0036226;2015-08-30;CLI00927;FACTURA;16;2;27709;5265;32974
FAC0036227;2015-07-26;CLI00424;FACTURA;41;1;40804;7753;48557
FAC0036228;2015-10-08;CLI00395;FACTURA;23;2;135355;25717;161072
FAC0036229;2015-11-02;CLI00474;FACTURA;39;1;10146;1928;12074
FAC0036230;2015-10-19;CLI00287;FACTURA;46;2;101532;19291;120823
FAC0036231;2015-02-28;CLI00615;FACTURA;8;2;59136;11236;70372
FAC0036232;2015-07-06;CLI00547;FACTURA;2;2;35272;6702;41974
FAC0036233;2015-03-05;CLI00262;FACTURA;12;1;221517;42088;263605
FAC0036234;2015-12-13;CLI00461;FACTURA;29;2;285080;54165;339245
FAC0036235;2015-02-03;CLI00966;FACTURA;49;1;101460;19277;120737
FAC0036236;2015-09-21;CLI00384;FACTURA;33;1;25473;4840;30313
FAC0036237;2015-04-16;CLI00649;FACTURA;47;2;211170;40122;251292
FAC0036238;2015-03-31;CLI00939;FACTURA;20;2;56691;10771;67462
FAC0036239;2015-05-03;CLI00236;FACTURA;44;1;32070;6093;38163
FAC0036240;2015-07-29;CLI00269;FACTURA;38;2;222012;42182;264194
FAC0036241;2015-08-22;CLI00198;FACTURA;44;1;277090;52647;329737
FAC0036242;2015-09-07;CLI00004;FACTURA;23;1;102010;19382;121392
FAC0036243;2015-03-02;CLI00192;FACTURA;49;1;28668;5447;34115
FAC0036244;2015-01-14;CLI00708;FACTURA;30;1;10201;1938;12139
FAC0036245;2015-04-13;CLI00339;FACTURA;1;2;214100;40679;254779
FAC0036246;2015-03-16;CLI00982;FACTURA;25;1;61029;11596;72625
FAC0036247;2015-01-20;CLI00423;FACTURA;49;2;109025;20715;129740
FAC0036248;2015-11-26;CLI00035;FACTURA;14;2;16035;3047;19082
FAC0036249;2015-01-12;CLI00036;FACTURA;6;1;57336;10894;68230
FAC0036250;2015-04-06;CLI00595;FACTURA;21;2;139216;26451;165667
FAC0036251;2015-08-17;CLI00225;FACTURA;31;2;63568;12078;75646
FAC0036252;2015-11-16;CLI00295;FACTURA;4;2;229362;43579;272941
FAC0036253;2015-11-27;CLI00191;FACTURA;9;2;141088;26807;167895
FAC0036254;2015-02-15;CLI00650;FACTURA;7;1;203751;38713;242464
FAC0036255;2015-12-07;CLI00878;FACTURA;32;1;262128;49804;311932
FAC0036256;2015-09-28;CLI00206;FACTURA;34;1;98672;18748;117420
FAC0036257;2015-10-01;CLI00590;FACTURA;28;1;71514;13588;85102
FAC0036258;2015-12-15;CLI00397;FACTURA;12;2;127030;24136;151166
FAC0036259;2015-08-29;CLI00081;FACTURA;45;2;13674;2598;16272
FAC0036260;2015-05-01;CLI00096;FACTURA;45;1;273496;51964;325460
FAC0036261;2015-03-22;CLI00612;FACTURA;46;1;197344;37495;234839
FAC0036262;2015-12-17;CLI00669;FACTURA;32;2;63291;12025;75316
FAC0036263;2015-12-17;CLI00680;FACTURA;48;1;35272;6702;41974
FAC0036264;2015-10-19;CLI00511;FACTURA;7;2;6179;1174;7353
FAC0036265;2015-08-19;CLI00523;FACTURA;26;2;192690;36611;229301
FAC0036266;2015-11-26;CLI00452;FACTURA;23;1;65577;12460;78037
FAC0036267;2015-09-07;CLI00632;FACTURA;13;1;218050;41430;259480
FAC0036268;2015-08-01;CLI00332;FACTURA;33;1;151788;28840;180628
FAC0036269;2015-07-05;CLI00631;FACTURA;27;2;26583;5051;31634
FAC0036270;2015-08-29;CLI00622;FACTURA;34;1;26583;5051;31634
FAC0036271;2015-01-12;CLI00587;FACTURA;29;2;100735;19140;119875
FAC0036272;2015-07-02;CLI00334;FACTURA;31;1;32272;6132;38404
FAC0036273;2015-10-17;CLI00723;FACTURA;22;2;227682;43260;270942
FAC0036274;2015-08-07;CLI00799;FACTURA;17;2;123065;23382;146447
FAC0036275;2015-08-01;CLI00843;FACTURA;33;2;143340;27235;170575
FAC0036276;2015-11-20;CLI00460;FACTURA;47;1;195060;37061;232121
FAC0036277;2015-05-31;CLI00610;FACTURA;17;1;52395;9955;62350
FAC0036278;2015-05-21;CLI00417;FACTURA;24;2;138545;26324;164869
FAC0036279;2015-01-03;CLI00153;FACTURA;18;2;221517;42088;263605
FAC0036280;2015-09-30;CLI00372;FACTURA;48;1;161360;30658;192018
FAC0036281;2015-12-25;CLI00061;FACTURA;10;2;272430;51762;324192
FAC0036282;2015-03-31;CLI00732;FACTURA;6;1;9446;1795;11241
FAC0036283;2015-12-11;CLI00990;FACTURA;33;1;68619;13038;81657
FAC0036284;2015-12-20;CLI00896;FACTURA;39;1;160111;30421;190532
FAC0036285;2015-03-01;CLI00866;FACTURA;4;1;18966;3604;22570
FAC0036286;2015-04-19;CLI00310;FACTURA;8;1;58518;11118;69636
FAC0036287;2015-06-18;CLI00259;FACTURA;28;2;152635;29001;181636
FAC0036288;2015-02-21;CLI00373;FACTURA;34;2;239309;45469;284778
FAC0036289;2015-09-15;CLI00625;FACTURA;37;2;160111;30421;190532
FAC0036290;2015-06-04;CLI00930;FACTURA;20;1;108972;20705;129677
FAC0036291;2015-11-08;CLI00325;FACTURA;38;2;61790;11740;73530
FAC0036292;2015-03-02;CLI00346;FACTURA;28;1;87220;16572;103792
FAC0036293;2015-09-05;CLI00584;FACTURA;28;1;40686;7730;48416
FAC0036294;2015-04-25;CLI00975;FACTURA;36;2;56691;10771;67462
FAC0036295;2015-06-13;CLI00488;FACTURA;36;1;37074;7044;44118
FAC0036296;2015-03-20;CLI00473;FACTURA;20;2;24716;4696;29412
FAC0036297;2015-06-29;CLI00375;FACTURA;20;2;208260;39569;247829
FAC0036298;2015-03-18;CLI00173;FACTURA;19;2;285080;54165;339245
FAC0036299;2015-11-11;CLI00287;FACTURA;2;2;75864;14414;90278
FAC0036300;2015-10-29;CLI00879;FACTURA;14;2;23834;4528;28362
FAC0036301;2015-02-23;CLI00078;FACTURA;13;1;37074;7044;44118
FAC0036302;2015-07-19;CLI00837;FACTURA;8;2;117036;22237;139273
FAC0036303;2015-09-03;CLI00581;FACTURA;19;2;44412;8438;52850
FAC0036304;2015-07-03;CLI00033;FACTURA;31;2;57336;10894;68230
FAC0036305;2015-10-04;CLI00209;FACTURA;10;2;59585;11321;70906
FAC0036306;2015-11-14;CLI00114;FACTURA;45;1;64140;12187;76327
FAC0036307;2015-11-18;CLI00778;FACTURA;41;1;27709;5265;32974
FAC0036308;2015-09-28;CLI00334;FACTURA;50;1;19506;3706;23212
FAC0036309;2015-12-22;CLI00653;FACTURA;43;2;68374;12991;81365
FAC0036310;2015-03-11;CLI00083;FACTURA;16;2;71670;13617;85287
FAC0036311;2015-04-25;CLI00128;FACTURA;1;1;312390;59354;371744
FAC0036312;2015-04-29;CLI00213;FACTURA;39;2;229362;43579;272941
FAC0036313;2015-04-20;CLI00261;FACTURA;23;2;261027;49595;310622
FAC0036314;2015-02-05;CLI00879;FACTURA;17;2;50596;9613;60209
FAC0036315;2015-07-27;CLI00427;FACTURA;49;2;107050;20340;127390
FAC0036316;2015-02-03;CLI00949;FACTURA;23;2;122058;23191;145249
FAC0036317;2015-03-10;CLI00429;FACTURA;28;2;54142;10287;64429
FAC0036318;2015-03-14;CLI00627;FACTURA;8;2;147678;28059;175737
FAC0036319;2015-03-14;CLI00678;FACTURA;50;1;45816;8705;54521
FAC0036320;2015-05-27;CLI00570;FACTURA;31;1;91492;17383;108875
FAC0036321;2015-03-02;CLI00297;FACTURA;14;2;196904;37412;234316
FAC0036322;2015-08-13;CLI00120;FACTURA;21;1;84610;16076;100686
FAC0036323;2015-06-19;CLI00038;FACTURA;46;1;87220;16572;103792
FAC0036324;2015-06-20;CLI00043;FACTURA;35;2;201582;38301;239883
FAC0036325;2015-01-20;CLI00930;FACTURA;22;1;60441;11484;71925
FAC0036326;2015-02-27;CLI00254;FACTURA;21;1;68370;12990;81360
FAC0036327;2015-06-30;CLI00609;FACTURA;18;2;31784;6039;37823
FAC0036328;2015-03-30;CLI00490;FACTURA;32;1;76419;14520;90939
FAC0036329;2015-04-15;CLI00381;FACTURA;48;2;42234;8024;50258
FAC0036330;2015-02-13;CLI00844;FACTURA;1;1;23834;4528;28362
FAC0036331;2015-10-13;CLI00191;FACTURA;14;2;256572;48749;305321
FAC0036332;2015-09-03;CLI00429;FACTURA;37;2;128280;24373;152653
FAC0036333;2015-12-27;CLI00220;FACTURA;26;1;31784;6039;37823
FAC0036334;2015-10-18;CLI00760;FACTURA;13;1;39466;7499;46965
FAC0036335;2015-02-28;CLI00846;FACTURA;44;1;64544;12263;76807
FAC0036336;2015-02-20;CLI00421;FACTURA;45;2;79460;15097;94557
FAC0036337;2015-09-18;CLI00558;FACTURA;14;1;114032;21666;135698
FAC0036338;2015-01-23;CLI00427;FACTURA;33;2;221517;42088;263605
FAC0036339;2015-04-25;CLI00042;FACTURA;8;1;278432;52902;331334
FAC0036340;2015-01-23;CLI00929;FACTURA;37;2;33597;6383;39980
FAC0036341;2015-03-27;CLI00114;FACTURA;48;1;91809;17444;109253
FAC0036342;2015-02-13;CLI00359;FACTURA;43;2;27348;5196;32544
FAC0036343;2015-03-15;CLI00810;FACTURA;46;1;28508;5417;33925
FAC0036344;2015-05-22;CLI00810;FACTURA;20;1;190701;36233;226934
FAC0036345;2015-10-13;CLI00662;FACTURA;21;1;31784;6039;37823
FAC0036346;2015-01-05;CLI00025;FACTURA;50;2;113195;21507;134702
FAC0036347;2015-10-28;CLI00419;FACTURA;22;2;64230;12204;76434
FAC0036348;2015-05-15;CLI00565;FACTURA;10;2;168776;32067;200843
FAC0036349;2015-09-24;CLI00768;FACTURA;12;1;327660;62255;389915
FAC0036350;2015-08-29;CLI00471;FACTURA;20;2;189873;36076;225949
FAC0036351;2015-08-25;CLI00049;FACTURA;9;2;177086;33646;210732
FAC0036352;2015-08-19;CLI00209;FACTURA;24;2;98452;18706;117158
FAC0036353;2015-03-15;CLI00251;FACTURA;50;2;49432;9392;58824
FAC0036354;2015-01-19;CLI00137;FACTURA;13;2;82044;15588;97632
FAC0036355;2015-02-02;CLI00116;FACTURA;37;1;40686;7730;48416
FAC0036356;2015-12-08;CLI00526;FACTURA;9;1;235179;44684;279863
FAC0036357;2015-03-29;CLI00302;FACTURA;31;1;141029;26796;167825
FAC0036358;2015-11-13;CLI00020;FACTURA;42;1;178311;33879;212190
FAC0036359;2015-03-12;CLI00925;FACTURA;43;2;116012;22042;138054
FAC0036360;2015-10-24;CLI00879;FACTURA;4;2;203248;38617;241865
FAC0036361;2015-07-19;CLI00289;FACTURA;37;2;212664;40406;253070
FAC0036362;2015-03-30;CLI00360;FACTURA;40;1;159498;30305;189803
FAC0036363;2015-10-17;CLI00165;FACTURA;45;2;147678;28059;175737
FAC0036364;2015-02-09;CLI00985;FACTURA;43;2;181323;34451;215774
FAC0036365;2015-06-18;CLI00191;FACTURA;7;2;40804;7753;48557
FAC0036366;2015-08-30;CLI00568;FACTURA;43;1;139216;26451;165667
FAC0036367;2015-10-26;CLI00349;FACTURA;41;2;239247;45457;284704
FAC0036368;2015-03-16;CLI00731;FACTURA;24;2;11276;2142;13418
FAC0036369;2015-11-24;CLI00096;FACTURA;6;1;80178;15234;95412
FAC0036370;2015-01-24;CLI00706;FACTURA;15;1;312390;59354;371744
FAC0036371;2015-05-04;CLI00911;FACTURA;32;2;294894;56030;350924
FAC0036372;2015-11-12;CLI00179;FACTURA;24;2;18897;3590;22487
FAC0036373;2015-03-06;CLI00152;FACTURA;31;1;136740;25981;162721
FAC0036374;2015-07-02;CLI00942;FACTURA;32;1;58006;11021;69027
FAC0036375;2015-11-16;CLI00107;FACTURA;4;2;195060;37061;232121
FAC0036376;2015-04-18;CLI00047;FACTURA;10;2;196904;37412;234316
FAC0036377;2015-01-25;CLI00940;FACTURA;18;1;76032;14446;90478
FAC0036378;2015-12-02;CLI00834;FACTURA;14;1;25298;4807;30105
FAC0036379;2015-08-21;CLI00028;FACTURA;12;1;6179;1174;7353
FAC0036380;2015-07-14;CLI00317;FACTURA;29;2;208260;39569;247829
FAC0036381;2015-05-27;CLI00827;FACTURA;15;2;192690;36611;229301
FAC0036382;2015-06-02;CLI00138;FACTURA;16;1;130830;24858;155688
FAC0036383;2015-11-16;CLI00644;FACTURA;14;1;49336;9374;58710
FAC0036384;2015-07-26;CLI00773;FACTURA;48;2;58518;11118;69636
FAC0036385;2015-08-28;CLI00512;FACTURA;25;1;50688;9631;60319
FAC0036386;2015-07-23;CLI00209;FACTURA;42;2;208824;39677;248501
FAC0036387;2015-06-04;CLI00775;FACTURA;12;2;114032;21666;135698
FAC0036388;2015-11-24;CLI00743;FACTURA;3;2;28111;5341;33452
FAC0036389;2015-01-08;CLI00048;FACTURA;26;1;192690;36611;229301
FAC0036390;2015-01-03;CLI00950;FACTURA;36;1;45104;8570;53674
FAC0036391;2015-12-10;CLI00815;FACTURA;40;2;147679;28059;175738
FAC0036392;2015-04-21;CLI00245;FACTURA;46;2;24613;4676;29289
FAC0036393;2015-09-13;CLI00198;FACTURA;20;1;33792;6420;40212
FAC0036394;2015-08-22;CLI00829;FACTURA;22;2;112952;21461;134413
FAC0036395;2015-05-17;CLI00175;FACTURA;34;2;98452;18706;117158
FAC0036396;2015-09-24;CLI00909;FACTURA;30;2;57016;10833;67849
FAC0036397;2015-12-20;CLI00591;FACTURA;46;2;6170;1172;7342
FAC0036398;2015-01-06;CLI00205;FACTURA;5;2;135355;25717;161072
FAC0036399;2015-02-18;CLI00419;FACTURA;45;2;14334;2723;17057
FAC0036400;2015-01-11;CLI00155;FACTURA;35;2;91492;17383;108875
FAC0036401;2015-12-24;CLI00770;FACTURA;42;1;145015;27553;172568
FAC0036402;2015-02-28;CLI00297;FACTURA;45;2;87436;16613;104049
FAC0036403;2015-04-07;CLI00939;FACTURA;44;2;76032;14446;90478
FAC0036404;2015-05-24;CLI00891;FACTURA;6;2;197344;37495;234839
FAC0036405;2015-08-25;CLI00622;FACTURA;13;1;181323;34451;215774
FAC0036406;2015-01-10;CLI00024;FACTURA;36;1;254730;48399;303129
FAC0036407;2015-08-17;CLI00747;FACTURA;26;2;302373;57451;359824
FAC0036408;2015-06-09;CLI00625;FACTURA;39;2;95336;18114;113450
FAC0036409;2015-10-10;CLI00927;FACTURA;41;2;208260;39569;247829
FAC0036410;2015-03-03;CLI00615;FACTURA;48;2;27243;5176;32419
FAC0036411;2015-07-28;CLI00970;FACTURA;17;1;80680;15329;96009
FAC0036412;2015-02-10;CLI00494;FACTURA;50;1;94311;17919;112230
FAC0036413;2015-03-24;CLI00701;FACTURA;3;2;73839;14029;87868
FAC0036414;2015-06-20;CLI00001;FACTURA;10;2;203021;38574;241595
FAC0036415;2015-03-07;CLI00194;FACTURA;20;1;18510;3517;22027
FAC0036416;2015-12-29;CLI00113;FACTURA;27;2;85014;16153;101167
FAC0036417;2015-02-10;CLI00826;FACTURA;18;1;142401;27056;169457
FAC0036418;2015-06-09;CLI00235;FACTURA;41;2;27071;5143;32214
FAC0036419;2015-07-27;CLI00899;FACTURA;49;2;160350;30467;190817
FAC0036420;2015-01-02;CLI00135;FACTURA;10;2;66381;12612;78993
FAC0036421;2015-02-20;CLI00389;FACTURA;3;2;171280;32543;203823
FAC0036422;2015-04-25;CLI00302;FACTURA;39;1;28508;5417;33925
FAC0036423;2015-09-21;CLI00010;FACTURA;21;1;16136;3066;19202
FAC0036424;2015-06-20;CLI00581;FACTURA;29;2;16922;3215;20137
FAC0036425;2015-11-05;CLI00716;FACTURA;22;1;109392;20784;130176
FAC0036426;2015-08-18;CLI00632;FACTURA;15;1;47230;8974;56204
FAC0036427;2015-08-22;CLI00066;FACTURA;29;1;235179;44684;279863
FAC0036428;2015-07-14;CLI00441;FACTURA;44;2;40804;7753;48557
FAC0036429;2015-03-16;CLI00065;FACTURA;7;2;196596;37353;233949
FAC0036430;2015-10-09;CLI00970;FACTURA;25;1;27243;5176;32419
FAC0036431;2015-06-01;CLI00610;FACTURA;36;1;145015;27553;172568
FAC0036432;2015-03-26;CLI00967;FACTURA;16;2;70544;13403;83947
FAC0036433;2015-04-13;CLI00860;FACTURA;8;1;81608;15506;97114
FAC0036434;2015-08-15;CLI00678;FACTURA;9;1;58006;11021;69027
FAC0036435;2015-05-26;CLI00232;FACTURA;49;1;158724;30158;188882
FAC0036436;2015-04-18;CLI00474;FACTURA;3;1;103086;19586;122672
FAC0036437;2015-01-24;CLI00507;FACTURA;17;2;49336;9374;58710
FAC0036438;2015-10-25;CLI00040;FACTURA;24;1;43718;8306;52024
FAC0036439;2015-02-19;CLI00648;FACTURA;13;1;327660;62255;389915
FAC0036440;2015-03-05;CLI00446;FACTURA;44;1;341870;64955;406825
FAC0036441;2015-12-30;CLI00421;FACTURA;35;2;16896;3210;20106
FAC0036442;2015-09-18;CLI00591;FACTURA;30;2;59136;11236;70372
FAC0036443;2015-03-10;CLI00696;FACTURA;38;1;42240;8026;50266
FAC0036444;2015-12-25;CLI00080;FACTURA;10;1;335970;63834;399804
FAC0036445;2015-02-10;CLI00699;FACTURA;46;2;12340;2345;14685
FAC0036446;2015-11-12;CLI00957;FACTURA;33;2;171048;32499;203547
FAC0036447;2015-09-06;CLI00588;FACTURA;25;1;129006;24511;153517
FAC0036448;2015-05-06;CLI00846;FACTURA;20;1;126490;24033;150523
FAC0036449;2015-02-14;CLI00642;FACTURA;28;1;16922;3215;20137
FAC0036450;2015-09-27;CLI00662;FACTURA;46;1;128460;24407;152867
FAC0036451;2015-10-10;CLI00346;FACTURA;31;1;94460;17947;112407
FAC0036452;2015-06-19;CLI00660;FACTURA;40;1;132279;25133;157412
FAC0036453;2015-08-03;CLI00469;FACTURA;39;2;221672;42118;263790
FAC0036454;2015-11-08;CLI00292;FACTURA;39;1;116012;22042;138054
FAC0036455;2015-10-28;CLI00234;FACTURA;22;1;211170;40122;251292
FAC0036456;2015-04-16;CLI00714;FACTURA;39;1;81213;15430;96643
FAC0036457;2015-02-23;CLI00088;FACTURA;28;1;100338;19064;119402
FAC0036458;2015-10-26;CLI00673;FACTURA;35;2;170935;32478;203413
FAC0036459;2015-04-20;CLI00088;FACTURA;45;1;95718;18186;113904
FAC0036460;2015-11-04;CLI00057;FACTURA;39;2;64230;12204;76434
FAC0036461;2015-02-01;CLI00465;FACTURA;45;2;254060;48271;302331
FAC0036462;2015-07-11;CLI00087;FACTURA;20;2;11454;2176;13630
FAC0036463;2015-09-24;CLI00706;FACTURA;50;1;56380;10712;67092
FAC0036464;2015-04-09;CLI00805;FACTURA;32;2;63568;12078;75646
FAC0036465;2015-08-10;CLI00912;FACTURA;49;1;129088;24527;153615
FAC0036466;2015-08-30;CLI00821;FACTURA;27;2;30603;5815;36418
FAC0036467;2015-12-27;CLI00247;FACTURA;45;2;109295;20766;130061
FAC0036468;2015-03-10;CLI00276;FACTURA;34;1;108972;20705;129677
FAC0036469;2015-07-02;CLI00114;FACTURA;48;1;24668;4687;29355
FAC0036470;2015-04-02;CLI00460;FACTURA;15;1;8448;1605;10053
FAC0036471;2015-06-25;CLI00453;FACTURA;1;2;52908;10053;62961
FAC0036472;2015-04-20;CLI00899;FACTURA;10;2;203784;38719;242503
FAC0036473;2015-08-06;CLI00530;FACTURA;30;1;108284;20574;128858
FAC0036474;2015-10-16;CLI00426;FACTURA;31;1;109295;20766;130061
FAC0036475;2015-06-10;CLI00491;FACTURA;8;2;203784;38719;242503
FAC0036476;2015-03-14;CLI00450;FACTURA;46;1;28190;5356;33546
FAC0036477;2015-04-14;CLI00900;FACTURA;23;1;50730;9639;60369
FAC0036478;2015-10-19;CLI00145;FACTURA;25;2;145015;27553;172568
FAC0036479;2015-10-14;CLI00483;FACTURA;32;2;58518;11118;69636
FAC0036480;2015-08-02;CLI00985;FACTURA;36;2;66618;12657;79275
FAC0036481;2015-11-11;CLI00921;FACTURA;6;2;132279;25133;157412
FAC0036482;2015-08-19;CLI00374;FACTURA;4;1;104412;19838;124250
FAC0036483;2015-07-27;CLI00772;FACTURA;8;1;97530;18531;116061
FAC0036484;2015-01-08;CLI00902;FACTURA;27;1;33792;6420;40212
FAC0036485;2015-12-03;CLI00187;FACTURA;15;2;50766;9646;60412
FAC0036486;2015-10-22;CLI00964;FACTURA;44;1;7946;1510;9456
FAC0036487;2015-05-28;CLI00099;FACTURA;7;2;102561;19487;122048
FAC0036488;2015-08-27;CLI00891;FACTURA;11;2;188970;35904;224874
FAC0036489;2015-04-20;CLI00730;FACTURA;29;1;108972;20705;129677
FAC0036490;2015-02-13;CLI00852;FACTURA;9;1;246130;46765;292895
FAC0036491;2015-01-07;CLI00988;FACTURA;34;1;11917;2264;14181
FAC0036492;2015-07-30;CLI00590;FACTURA;40;1;112952;21461;134413
FAC0036493;2015-11-16;CLI00618;FACTURA;1;1;83832;15928;99760
FAC0036494;2015-05-27;CLI00772;FACTURA;32;1;161176;30623;191799
FAC0036495;2015-11-13;CLI00724;FACTURA;17;1;84480;16051;100531
FAC0036496;2015-05-19;CLI00329;FACTURA;14;2;21097;4008;25105
FAC0036497;2015-12-04;CLI00480;FACTURA;34;1;40584;7711;48295
FAC0036498;2015-02-05;CLI00735;FACTURA;39;2;228064;43332;271396
FAC0036499;2015-01-23;CLI00030;FACTURA;39;1;54142;10287;64429
FAC0036500;2015-08-13;CLI00387;FACTURA;44;2;52395;9955;62350
FAC0036501;2015-03-08;CLI00385;FACTURA;33;2;62874;11946;74820
FAC0036502;2015-12-19;CLI00956;FACTURA;49;1;144315;27420;171735
FAC0036503;2015-04-27;CLI00785;FACTURA;25;2;84388;16034;100422
FAC0036504;2015-01-18;CLI00258;FACTURA;30;1;145224;27593;172817
FAC0036505;2015-10-27;CLI00988;FACTURA;41;1;135355;25717;161072
FAC0036506;2015-06-03;CLI00716;FACTURA;34;1;105816;20105;125921
FAC0036507;2015-07-21;CLI00836;FACTURA;39;1;37794;7181;44975
FAC0036508;2015-11-01;CLI00457;FACTURA;35;2;24716;4696;29412
FAC0036509;2015-02-25;CLI00743;FACTURA;49;2;109295;20766;130061
FAC0036510;2015-05-23;CLI00633;FACTURA;11;2;85640;16272;101912
FAC0036511;2015-10-07;CLI00903;FACTURA;24;2;88180;16754;104934
FAC0036512;2015-05-20;CLI00020;FACTURA;34;1;76419;14520;90939
FAC0036513;2015-05-09;CLI00133;FACTURA;8;2;138840;26380;165220
FAC0036514;2015-03-24;CLI00246;FACTURA;50;1;61790;11740;73530
FAC0036515;2015-07-07;CLI00239;FACTURA;15;2;152436;28963;181399
FAC0036516;2015-08-01;CLI00400;FACTURA;37;1;171048;32499;203547
FAC0036517;2015-05-05;CLI00530;FACTURA;26;1;119170;22642;141812
FAC0036518;2015-11-01;CLI00582;FACTURA;39;1;33597;6383;39980
FAC0036519;2015-08-31;CLI00944;FACTURA;24;1;20402;3876;24278
FAC0036520;2015-07-22;CLI00354;FACTURA;27;1;229257;43559;272816
FAC0036521;2015-06-25;CLI00549;FACTURA;3;2;84468;16049;100517
FAC0036522;2015-04-09;CLI00834;FACTURA;7;1;120882;22968;143850
FAC0036523;2015-03-15;CLI00208;FACTURA;25;1;134388;25534;159922
FAC0036524;2015-07-27;CLI00536;FACTURA;31;1;63568;12078;75646
FAC0036525;2015-12-01;CLI00469;FACTURA;5;2;27243;5176;32419
FAC0036526;2015-05-19;CLI00269;FACTURA;26;2;254060;48271;302331
FAC0036527;2015-04-06;CLI00560;FACTURA;18;1;24680;4689;29369
FAC0036528;2015-12-14;CLI00331;FACTURA;13;2;341870;64955;406825
FAC0036529;2015-02-11;CLI00093;FACTURA;7;2;54486;10352;64838
FAC0036530;2015-04-05;CLI00473;FACTURA;37;2;21097;4008;25105
FAC0036531;2015-11-30;CLI00659;FACTURA;35;2;56222;10682;66904
FAC0036532;2015-11-13;CLI00233;FACTURA;10;2;104130;19785;123915
FAC0036533;2015-06-16;CLI00860;FACTURA;26;1;162744;30921;193665
FAC0036534;2015-09-03;CLI00502;FACTURA;44;1;114540;21763;136303
FAC0036535;2015-08-22;CLI00727;FACTURA;22;2;221672;42118;263790
FAC0036536;2015-12-18;CLI00366;FACTURA;16;1;68724;13058;81782
FAC0036537;2015-01-31;CLI00787;FACTURA;3;2;50742;9641;60383
FAC0036538;2015-05-30;CLI00745;FACTURA;48;2;18897;3590;22487
FAC0036539;2015-10-12;CLI00493;FACTURA;41;2;228730;43459;272189
FAC0036540;2015-02-04;CLI00350;FACTURA;1;1;61206;11629;72835
FAC0036541;2015-02-21;CLI00706;FACTURA;35;1;69420;13190;82610
FAC0036542;2015-09-07;CLI00838;FACTURA;23;1;218050;41430;259480
FAC0036543;2015-11-17;CLI00885;FACTURA;36;2;199556;37916;237472
FAC0036544;2015-09-25;CLI00091;FACTURA;48;2;16136;3066;19202
FAC0036545;2015-04-08;CLI00218;FACTURA;40;1;16914;3214;20128
FAC0036546;2015-07-05;CLI00198;FACTURA;36;1;17636;3351;20987
FAC0036547;2015-07-01;CLI00233;FACTURA;3;2;152436;28963;181399
FAC0036548;2015-11-03;CLI00251;FACTURA;13;2;135355;25717;161072
FAC0036549;2015-09-17;CLI00426;FACTURA;48;1;131154;24919;156073
FAC0036550;2015-06-20;CLI00873;FACTURA;40;2;199556;37916;237472
FAC0036551;2015-11-19;CLI00456;FACTURA;6;1;171048;32499;203547
FAC0036552;2015-01-24;CLI00136;FACTURA;36;1;57270;10881;68151
FAC0036553;2015-06-08;CLI00775;FACTURA;23;2;109295;20766;130061
FAC0036554;2015-06-25;CLI00984;FACTURA;8;1;68619;13038;81657
FAC0036555;2015-05-20;CLI00439;FACTURA;29;2;188970;35904;224874
FAC0036556;2015-05-24;CLI00085;FACTURA;36;2;196596;37353;233949
FAC0036557;2015-11-06;CLI00873;FACTURA;1;2;26583;5051;31634
FAC0036558;2015-07-28;CLI00810;FACTURA;24;1;91314;17350;108664
FAC0036559;2015-06-05;CLI00188;FACTURA;30;1;216568;41148;257716
FAC0036560;2015-04-26;CLI00944;FACTURA;10;1;64140;12187;76327
FAC0036561;2015-03-19;CLI00714;FACTURA;41;1;186081;35355;221436
FAC0036562;2015-01-07;CLI00352;FACTURA;47;1;50812;9654;60466
FAC0036563;2015-04-08;CLI00770;FACTURA;31;1;18510;3517;22027
FAC0036564;2015-10-23;CLI00275;FACTURA;42;2;137238;26075;163313
FAC0036565;2015-11-26;CLI00638;FACTURA;41;1;28190;5356;33546
FAC0036566;2015-11-04;CLI00724;FACTURA;36;1;122058;23191;145249
FAC0036567;2015-09-17;CLI00269;FACTURA;44;2;50596;9613;60209
FAC0036568;2015-08-31;CLI00044;FACTURA;31;1;214100;40679;254779
FAC0036569;2015-07-05;CLI00128;FACTURA;3;1;42240;8026;50266
FAC0036570;2015-07-04;CLI00759;FACTURA;43;2;67688;12861;80549
FAC0036571;2015-03-20;CLI00784;FACTURA;12;1;25406;4827;30233
FAC0036572;2015-05-02;CLI00619;FACTURA;4;2;142401;27056;169457
FAC0036573;2015-03-20;CLI00718;FACTURA;5;1;59136;11236;70372
FAC0036574;2015-11-17;CLI00436;FACTURA;8;1;196596;37353;233949
FAC0036575;2015-05-08;CLI00063;FACTURA;12;2;18897;3590;22487
FAC0036576;2015-07-17;CLI00012;FACTURA;32;1;68724;13058;81782
FAC0036577;2015-05-15;CLI00487;FACTURA;19;2;91632;17410;109042
FAC0036578;2015-09-16;CLI00886;FACTURA;5;1;112952;21461;134413
FAC0036579;2015-06-23;CLI00737;FACTURA;22;2;40804;7753;48557
FAC0036580;2015-05-10;CLI00490;FACTURA;49;1;106332;20203;126535
FAC0036581;2015-09-10;CLI00570;FACTURA;7;1;123452;23456;146908
FAC0036582;2015-06-23;CLI00621;FACTURA;39;2;91314;17350;108664
FAC0036583;2015-05-11;CLI00283;FACTURA;34;2;51005;9691;60696
FAC0036584;2015-05-15;CLI00416;FACTURA;31;1;43190;8206;51396
FAC0036585;2015-12-25;CLI00231;FACTURA;29;2;74004;14061;88065
FAC0036586;2015-12-14;CLI00520;FACTURA;47;1;11276;2142;13418
FAC0036587;2015-01-24;CLI00604;FACTURA;43;1;127030;24136;151166
FAC0036588;2015-12-28;CLI00016;FACTURA;8;1;23834;4528;28362
FAC0036589;2015-04-23;CLI00569;FACTURA;22;2;143340;27235;170575
FAC0036590;2015-03-10;CLI00035;FACTURA;19;2;68619;13038;81657
FAC0036591;2015-03-13;CLI00370;FACTURA;22;1;50596;9613;60209
FAC0036592;2015-02-27;CLI00454;FACTURA;2;1;261027;49595;310622
FAC0036593;2015-11-03;CLI00412;FACTURA;14;1;42194;8017;50211
FAC0036594;2015-11-29;CLI00918;FACTURA;50;1;101192;19226;120418
FAC0036595;2015-01-28;CLI00619;FACTURA;34;2;84610;16076;100686
FAC0036596;2015-10-16;CLI00615;FACTURA;43;2;254730;48399;303129
FAC0036597;2015-06-26;CLI00263;FACTURA;16;2;8448;1605;10053
FAC0036598;2015-11-20;CLI00622;FACTURA;15;1;28111;5341;33452
FAC0036599;2015-07-14;CLI00971;FACTURA;8;2;16914;3214;20128
FAC0036600;2015-05-04;CLI00986;FACTURA;31;1;107050;20340;127390
FAC0036601;2015-03-07;CLI00788;FACTURA;13;1;94311;17919;112230
FAC0036602;2015-06-23;CLI00627;FACTURA;14;2;56222;10682;66904
FAC0036603;2015-03-26;CLI00709;FACTURA;37;2;167985;31917;199902
FAC0036604;2015-01-15;CLI00814;FACTURA;42;1;126582;24051;150633
FAC0036605;2015-07-06;CLI00109;FACTURA;28;2;55622;10568;66190
FAC0036606;2015-07-06;CLI00410;FACTURA;42;1;91632;17410;109042
FAC0036607;2015-03-29;CLI00998;FACTURA;3;1;170073;32314;202387
FAC0036608;2015-01-15;CLI00510;FACTURA;12;1;212664;40406;253070
FAC0036609;2015-08-25;CLI00957;FACTURA;6;2;22873;4346;27219
FAC0036610;2015-08-29;CLI00881;FACTURA;32;2;98298;18677;116975
FAC0036611;2015-07-18;CLI00513;FACTURA;25;2;73839;14029;87868
FAC0036612;2015-06-15;CLI00903;FACTURA;29;2;84468;16049;100517
FAC0036613;2015-12-31;CLI00381;FACTURA;15;2;60876;11566;72442
FAC0036614;2015-10-14;CLI00361;FACTURA;8;2;145015;27553;172568
FAC0036615;2015-10-06;CLI00638;FACTURA;19;1;25344;4815;30159
FAC0036616;2015-09-19;CLI00853;FACTURA;18;2;136542;25943;162485
FAC0036617;2015-03-06;CLI00996;FACTURA;49;1;61790;11740;73530
FAC0036618;2015-11-17;CLI00873;FACTURA;3;2;192690;36611;229301
FAC0036619;2015-10-14;CLI00784;FACTURA;24;1;59585;11321;70906
FAC0036620;2015-03-30;CLI00876;FACTURA;23;1;66618;12657;79275
FAC0036621;2015-05-10;CLI00412;FACTURA;32;1;25344;4815;30159
FAC0036622;2015-02-23;CLI00306;FACTURA;18;1;189873;36076;225949
FAC0036623;2015-03-02;CLI00915;FACTURA;20;2;101715;19326;121041
FAC0036624;2015-02-06;CLI00066;FACTURA;7;1;43253;8218;51471
FAC0036625;2015-04-21;CLI00571;FACTURA;37;2;100735;19140;119875
FAC0036626;2015-12-27;CLI00746;FACTURA;20;1;48105;9140;57245
FAC0036627;2015-09-12;CLI00651;FACTURA;28;2;168936;32098;201034
FAC0036628;2015-05-24;CLI00207;FACTURA;3;2;134388;25534;159922
FAC0036629;2015-04-04;CLI00935;FACTURA;45;2;16896;3210;20106
FAC0036630;2015-09-16;CLI00881;FACTURA;2;2;98672;18748;117420
FAC0036631;2015-10-23;CLI00898;FACTURA;21;1;111030;21096;132126
FAC0036632;2015-10-25;CLI00920;FACTURA;29;1;28668;5447;34115
FAC0036633;2015-08-18;CLI00025;FACTURA;8;2;54486;10352;64838
FAC0036634;2015-05-18;CLI00236;FACTURA;43;1;181323;34451;215774
FAC0036635;2015-01-30;CLI00211;FACTURA;32;2;201582;38301;239883
FAC0036636;2015-05-07;CLI00955;FACTURA;14;2;43190;8206;51396
FAC0036637;2015-01-02;CLI00166;FACTURA;17;1;71514;13588;85102
FAC0036638;2015-04-05;CLI00436;FACTURA;3;1;128280;24373;152653
FAC0036639;2015-03-20;CLI00690;FACTURA;4;1;67194;12767;79961
FAC0036640;2015-06-09;CLI00079;FACTURA;17;2;40584;7711;48295
FAC0036641;2015-03-22;CLI00357;FACTURA;13;2;136542;25943;162485
FAC0036642;2015-07-29;CLI00597;FACTURA;40;2;265830;50508;316338
FAC0036643;2015-06-22;CLI00062;FACTURA;46;1;88180;16754;104934
FAC0036644;2015-05-27;CLI00635;FACTURA;43;2;27709;5265;32974
FAC0036645;2015-12-03;CLI00642;FACTURA;40;1;168936;32098;201034
FAC0036646;2015-04-18;CLI00183;FACTURA;13;2;50742;9641;60383
FAC0036647;2015-07-15;CLI00315;FACTURA;11;2;203430;38652;242082
FAC0036648;2015-06-10;CLI00088;FACTURA;13;1;272430;51762;324192
FAC0036649;2015-12-16;CLI00090;FACTURA;42;1;13674;2598;16272
FAC0036650;2015-04-18;CLI00679;FACTURA;47;2;30895;5870;36765
FAC0036651;2015-07-25;CLI00482;FACTURA;6;1;28190;5356;33546
FAC0036652;2015-12-16;CLI00122;FACTURA;45;1;40584;7711;48295
FAC0036653;2015-07-20;CLI00153;FACTURA;35;2;109025;20715;129740
FAC0036654;2015-09-24;CLI00405;FACTURA;12;2;56380;10712;67092
FAC0036655;2015-06-30;CLI00159;FACTURA;49;2;80588;15312;95900
FAC0036656;2015-04-19;CLI00805;FACTURA;19;2;122058;23191;145249
FAC0036657;2015-11-15;CLI00676;FACTURA;1;1;37784;7179;44963
FAC0036658;2015-07-23;CLI00868;FACTURA;19;1;9483;1802;11285
FAC0036659;2015-08-13;CLI00975;FACTURA;46;2;270710;51435;322145
FAC0036660;2015-06-13;CLI00304;FACTURA;37;1;122058;23191;145249
FAC0036661;2015-07-22;CLI00741;FACTURA;33;2;81213;15430;96643
FAC0036662;2015-04-11;CLI00022;FACTURA;18;1;272430;51762;324192
FAC0036663;2015-03-15;CLI00364;FACTURA;39;1;81372;15461;96833
FAC0036664;2015-01-25;CLI00913;FACTURA;15;2;174020;33064;207084
FAC0036665;2015-03-20;CLI00861;FACTURA;9;2;83127;15794;98921
FAC0036666;2015-12-23;CLI00651;FACTURA;32;2;111030;21096;132126
FAC0036667;2015-10-02;CLI00470;FACTURA;49;1;168936;32098;201034
FAC0036668;2015-04-08;CLI00834;FACTURA;17;1;302373;57451;359824
FAC0036669;2015-09-06;CLI00916;FACTURA;26;1;71022;13494;84516
FAC0036670;2015-09-26;CLI00468;FACTURA;15;1;162426;30861;193287
FAC0036671;2015-10-29;CLI00136;FACTURA;5;1;108284;20574;128858
FAC0036672;2015-04-21;CLI00200;FACTURA;11;1;42194;8017;50211
FAC0036673;2015-07-21;CLI00229;FACTURA;38;2;192690;36611;229301
FAC0036674;2015-04-15;CLI00894;FACTURA;24;1;27243;5176;32419
FAC0036675;2015-07-09;CLI00509;FACTURA;7;2;109295;20766;130061
FAC0036676;2015-08-03;CLI00276;FACTURA;29;1;129088;24527;153615
FAC0036677;2015-11-08;CLI00375;FACTURA;2;2;172291;32735;205026
FAC0036678;2015-05-07;CLI00986;FACTURA;3;1;8448;1605;10053
FAC0036679;2015-09-23;CLI00568;FACTURA;44;1;160350;30467;190817
FAC0036680;2015-02-19;CLI00008;FACTURA;18;1;19506;3706;23212
FAC0036681;2015-08-15;CLI00851;FACTURA;17;2;270710;51435;322145
FAC0036682;2015-04-02;CLI00074;FACTURA;13;1;21410;4068;25478
FAC0036683;2015-07-25;CLI00263;FACTURA;26;2;196245;37287;233532
FAC0036684;2015-07-22;CLI00294;FACTURA;42;1;142540;27083;169623
FAC0036685;2015-08-06;CLI00854;FACTURA;7;1;192690;36611;229301
FAC0036686;2015-11-08;CLI00805;FACTURA;18;2;127365;24199;151564
FAC0036687;2015-01-15;CLI00300;FACTURA;3;1;135834;25808;161642
FAC0036688;2015-12-27;CLI00166;FACTURA;4;1;18510;3517;22027
FAC0036689;2015-05-05;CLI00085;FACTURA;33;2;28508;5417;33925
FAC0036690;2015-12-14;CLI00366;FACTURA;49;1;25406;4827;30233
FAC0036691;2015-01-07;CLI00618;FACTURA;18;1;281110;53411;334521
FAC0036692;2015-10-09;CLI00161;FACTURA;14;2;22908;4353;27261
FAC0036693;2015-10-17;CLI00655;FACTURA;26;2;228064;43332;271396
FAC0036694;2015-08-12;CLI00063;FACTURA;37;2;172676;32808;205484
FAC0036695;2015-07-19;CLI00945;FACTURA;15;2;245187;46586;291773
FAC0036696;2015-07-19;CLI00873;FACTURA;42;2;242970;46164;289134
FAC0036697;2015-12-22;CLI00436;FACTURA;8;1;74004;14061;88065
FAC0036698;2015-12-14;CLI00615;FACTURA;14;2;27071;5143;32214
FAC0036699;2015-03-29;CLI00019;FACTURA;4;2;88180;16754;104934
FAC0036700;2015-02-25;CLI00962;FACTURA;45;1;134388;25534;159922
FAC0036701;2015-11-29;CLI00753;FACTURA;49;2;13674;2598;16272
FAC0036702;2015-04-16;CLI00523;FACTURA;38;2;101192;19226;120418
FAC0036703;2015-11-17;CLI00857;FACTURA;8;2;196245;37287;233532
FAC0036704;2015-06-24;CLI00117;FACTURA;49;2;252980;48066;301046
FAC0036705;2015-07-28;CLI00617;FACTURA;9;2;141088;26807;167895
FAC0036706;2015-03-08;CLI00223;FACTURA;21;2;123340;23435;146775
FAC0036707;2015-10-13;CLI00820;FACTURA;28;1;45104;8570;53674
FAC0036708;2015-12-16;CLI00607;FACTURA;42;2;122058;23191;145249
FAC0036709;2015-04-26;CLI00914;FACTURA;12;1;91809;17444;109253
FAC0036710;2015-04-20;CLI00820;FACTURA;3;1;63351;12037;75388
FAC0036711;2015-04-16;CLI00588;FACTURA;30;1;127365;24199;151564
FAC0036712;2015-09-28;CLI00779;FACTURA;30;2;98452;18706;117158
FAC0036713;2015-04-27;CLI00156;FACTURA;28;1;56676;10768;67444
FAC0036714;2015-05-02;CLI00937;FACTURA;19;2;59136;11236;70372
FAC0036715;2015-03-14;CLI00381;FACTURA;41;2;34362;6529;40891
FAC0036716;2015-10-17;CLI00186;FACTURA;42;1;87436;16613;104049
FAC0036717;2015-12-06;CLI00992;FACTURA;2;1;83832;15928;99760
FAC0036718;2015-07-09;CLI00993;FACTURA;25;2;104412;19838;124250
FAC0036719;2015-05-26;CLI00039;FACTURA;5;2;181323;34451;215774
FAC0036720;2015-10-05;CLI00030;FACTURA;19;1;57270;10881;68151
FAC0036721;2015-05-20;CLI00270;FACTURA;11;1;252999;48070;301069
FAC0036722;2015-09-09;CLI00057;FACTURA;28;2;131064;24902;155966
FAC0036723;2015-06-16;CLI00430;FACTURA;17;1;128460;24407;152867
FAC0036724;2015-07-13;CLI00476;FACTURA;24;1;161360;30658;192018
FAC0036725;2015-10-31;CLI00938;FACTURA;44;1;143340;27235;170575
FAC0036726;2015-06-08;CLI00211;FACTURA;25;2;126702;24073;150775
FAC0036727;2015-07-17;CLI00985;FACTURA;11;2;242970;46164;289134
FAC0036728;2015-09-12;CLI00086;FACTURA;16;1;153013;29072;182085
FAC0036729;2015-10-27;CLI00657;FACTURA;42;2;58006;11021;69027
FAC0036730;2015-12-31;CLI00736;FACTURA;35;1;18897;3590;22487
FAC0036731;2015-09-12;CLI00089;FACTURA;25;2;64544;12263;76807
FAC0036732;2015-07-15;CLI00911;FACTURA;12;2;47415;9009;56424
FAC0036733;2015-11-30;CLI00471;FACTURA;35;2;9446;1795;11241
FAC0036734;2015-06-20;CLI00364;FACTURA;3;1;42194;8017;50211
FAC0036735;2015-06-10;CLI00002;FACTURA;13;1;347100;65949;413049
FAC0036736;2015-05-28;CLI00680;FACTURA;40;1;218590;41532;260122
FAC0036737;2015-01-29;CLI00959;FACTURA;3;2;56380;10712;67092
FAC0036738;2015-05-07;CLI00221;FACTURA;26;2;114540;21763;136303
FAC0036739;2015-12-21;CLI00160;FACTURA;40;1;63351;12037;75388
FAC0036740;2015-07-30;CLI00786;FACTURA;42;1;190701;36233;226934
FAC0036741;2015-06-27;CLI00534;FACTURA;41;1;50766;9646;60412
FAC0036742;2015-04-12;CLI00319;FACTURA;33;2;105485;20042;125527
FAC0036743;2015-04-04;CLI00310;FACTURA;31;1;79460;15097;94557
FAC0036744;2015-01-17;CLI00844;FACTURA;22;1;25298;4807;30105
FAC0036745;2015-05-31;CLI00016;FACTURA;32;1;171280;32543;203823
FAC0036746;2015-11-24;CLI00205;FACTURA;49;2;218050;41430;259480
FAC0036747;2015-08-08;CLI00184;FACTURA;26;1;91492;17383;108875
FAC0036748;2015-11-17;CLI00020;FACTURA;19;1;50766;9646;60412
FAC0036749;2015-12-09;CLI00778;FACTURA;8;1;33792;6420;40212
FAC0036750;2015-09-28;CLI00345;FACTURA;37;2;242970;46164;289134
FAC0036751;2015-12-23;CLI00020;FACTURA;21;1;203751;38713;242464
FAC0036752;2015-11-03;CLI00396;FACTURA;15;1;174872;33226;208098
FAC0036753;2015-05-03;CLI00400;FACTURA;7;1;129088;24527;153615
FAC0036754;2015-05-14;CLI00669;FACTURA;39;2;32070;6093;38163
FAC0036755;2015-03-15;CLI00792;FACTURA;17;1;132279;25133;157412
FAC0036756;2015-03-15;CLI00988;FACTURA;19;1;37794;7181;44975
FAC0036757;2015-06-29;CLI00457;FACTURA;10;2;41022;7794;48816
FAC0036758;2015-08-01;CLI00900;FACTURA;32;1;45104;8570;53674
FAC0036759;2015-09-17;CLI00378;FACTURA;13;1;176360;33508;209868
FAC0036760;2015-06-03;CLI00244;FACTURA;38;1;18897;3590;22487
FAC0036761;2015-01-13;CLI00742;FACTURA;42;1;335970;63834;399804
FAC0036762;2015-04-23;CLI00676;FACTURA;23;1;27709;5265;32974
FAC0036763;2015-01-02;CLI00941;FACTURA;10;2;17636;3351;20987
FAC0036764;2015-08-15;CLI00607;FACTURA;32;2;312390;59354;371744
FAC0036765;2015-07-16;CLI00051;FACTURA;33;2;21117;4012;25129
FAC0036766;2015-02-26;CLI00914;FACTURA;10;1;76419;14520;90939
FAC0036767;2015-07-24;CLI00205;FACTURA;5;2;312390;59354;371744
FAC0036768;2015-03-23;CLI00969;FACTURA;21;2;33828;6427;40255
FAC0036769;2015-09-12;CLI00386;FACTURA;21;1;221672;42118;263790
FAC0036770;2015-06-08;CLI00929;FACTURA;23;2;50946;9680;60626
FAC0036771;2015-10-23;CLI00611;FACTURA;47;2;50946;9680;60626
FAC0036772;2015-07-02;CLI00227;FACTURA;5;2;126582;24051;150633
FAC0036773;2015-09-29;CLI00690;FACTURA;6;1;205857;39113;244970
FAC0036774;2015-02-22;CLI00415;FACTURA;48;2;24680;4689;29369
FAC0036775;2015-02-15;CLI00124;FACTURA;28;1;162426;30861;193287
FAC0036776;2015-11-29;CLI00381;FACTURA;50;2;141088;26807;167895
FAC0036777;2015-07-09;CLI00785;FACTURA;39;2;181112;34411;215523
FAC0036778;2015-08-26;CLI00848;FACTURA;33;1;47676;9058;56734
FAC0036779;2015-01-20;CLI00985;FACTURA;30;2;196596;37353;233949
FAC0036780;2015-08-26;CLI00304;FACTURA;38;1;56222;10682;66904
FAC0036781;2015-04-06;CLI00727;FACTURA;38;2;59585;11321;70906
FAC0036782;2015-05-18;CLI00600;FACTURA;46;1;196777;37388;234165
FAC0036783;2015-08-08;CLI00453;FACTURA;22;2;101532;19291;120823
FAC0036784;2015-03-18;CLI00332;FACTURA;12;1;84388;16034;100422
FAC0036785;2015-02-17;CLI00688;FACTURA;50;1;16136;3066;19202
FAC0036786;2015-01-30;CLI00431;FACTURA;23;2;76419;14520;90939
FAC0036787;2015-01-10;CLI00366;FACTURA;20;1;228730;43459;272189
FAC0036788;2015-09-23;CLI00696;FACTURA;27;1;218050;41430;259480
FAC0036789;2015-06-03;CLI00076;FACTURA;13;1;140555;26705;167260
FAC0036790;2015-04-04;CLI00938;FACTURA;1;1;277090;52647;329737
FAC0036791;2015-09-22;CLI00141;FACTURA;19;2;88180;16754;104934
FAC0036792;2015-04-03;CLI00451;FACTURA;4;2;96816;18395;115211
FAC0036793;2015-07-31;CLI00579;FACTURA;49;2;9446;1795;11241
FAC0036794;2015-01-05;CLI00334;FACTURA;23;1;174020;33064;207084
FAC0036795;2015-06-24;CLI00112;FACTURA;20;1;42194;8017;50211
FAC0036796;2015-03-01;CLI00630;FACTURA;21;1;74004;14061;88065
FAC0036797;2015-04-24;CLI00699;FACTURA;23;2;66122;12563;78685
FAC0036798;2015-01-04;CLI00178;FACTURA;43;1;177086;33646;210732
FAC0036799;2015-02-24;CLI00621;FACTURA;34;2;128460;24407;152867
FAC0036800;2015-02-06;CLI00066;FACTURA;39;1;239309;45469;284778
FAC0036801;2015-06-01;CLI00997;FACTURA;18;2;49226;9353;58579
FAC0036802;2015-09-04;CLI00241;FACTURA;44;2;158473;30110;188583
FAC0036803;2015-06-07;CLI00087;FACTURA;35;2;214100;40679;254779
FAC0036804;2015-08-20;CLI00497;FACTURA;34;2;114032;21666;135698
FAC0036805;2015-10-06;CLI00833;FACTURA;6;2;25473;4840;30313
FAC0036806;2015-05-14;CLI00828;FACTURA;20;1;98452;18706;117158
FAC0036807;2015-01-23;CLI00776;FACTURA;7;1;109025;20715;129740
FAC0036808;2015-02-14;CLI00010;FACTURA;36;1;100735;19140;119875
FAC0036809;2015-08-27;CLI00338;FACTURA;31;1;261027;49595;310622
FAC0036810;2015-08-03;CLI00265;FACTURA;33;2;95718;18186;113904
FAC0036811;2015-10-30;CLI00503;FACTURA;20;2;135376;25721;161097
FAC0036812;2015-04-10;CLI00919;FACTURA;50;2;172676;32808;205484
FAC0036813;2015-03-01;CLI00456;FACTURA;23;1;170935;32478;203413
FAC0036814;2015-11-26;CLI00223;FACTURA;17;2;67688;12861;80549
FAC0036815;2015-10-02;CLI00178;FACTURA;20;1;203430;38652;242082
FAC0036816;2015-08-26;CLI00120;FACTURA;4;1;104790;19910;124700
FAC0036817;2015-07-06;CLI00967;FACTURA;37;2;11276;2142;13418
FAC0036818;2015-10-05;CLI00154;FACTURA;41;1;23834;4528;28362
FAC0036819;2015-02-09;CLI00858;FACTURA;6;1;221672;42118;263790
FAC0036820;2015-07-22;CLI00674;FACTURA;5;1;84468;16049;100517
FAC0036821;2015-09-28;CLI00498;FACTURA;17;1;161360;30658;192018
FAC0036822;2015-03-13;CLI00367;FACTURA;24;2;21410;4068;25478
FAC0036823;2015-04-13;CLI00808;FACTURA;28;1;170073;32314;202387
FAC0036824;2015-08-17;CLI00195;FACTURA;13;2;107253;20378;127631
FAC0036825;2015-05-30;CLI00509;FACTURA;35;2;61790;11740;73530
FAC0036826;2015-01-20;CLI00216;FACTURA;38;1;24613;4676;29289
FAC0036827;2015-12-20;CLI00251;FACTURA;34;2;71670;13617;85287
FAC0036828;2015-04-23;CLI00707;FACTURA;27;2;262128;49804;311932
FAC0036829;2015-10-31;CLI00950;FACTURA;26;1;24716;4696;29412
FAC0036830;2015-02-16;CLI00024;FACTURA;40;1;252980;48066;301046
FAC0036831;2015-12-29;CLI00105;FACTURA;21;2;30603;5815;36418
FAC0036832;2015-08-11;CLI00008;FACTURA;13;1;64140;12187;76327
FAC0036833;2015-01-12;CLI00212;FACTURA;20;1;34710;6595;41305
FAC0036834;2015-03-05;CLI00671;FACTURA;29;2;42820;8136;50956
FAC0036835;2015-09-09;CLI00304;FACTURA;29;1;10146;1928;12074
FAC0036836;2015-06-16;CLI00576;FACTURA;38;1;145015;27553;172568
FAC0036837;2015-02-03;CLI00699;FACTURA;11;2;56691;10771;67462
FAC0036838;2015-12-13;CLI00462;FACTURA;6;1;47415;9009;56424
FAC0036839;2015-02-23;CLI00075;FACTURA;31;2;145224;27593;172817
FAC0036840;2015-03-11;CLI00950;FACTURA;23;1;9483;1802;11285
FAC0036841;2015-04-06;CLI00547;FACTURA;21;2;114365;21729;136094
FAC0036842;2015-08-21;CLI00979;FACTURA;2;2;97530;18531;116061
FAC0036843;2015-08-23;CLI00414;FACTURA;8;1;48105;9140;57245
FAC0036844;2015-04-10;CLI00286;FACTURA;31;1;205857;39113;244970
FAC0036845;2015-11-01;CLI00837;FACTURA;36;2;162744;30921;193665
FAC0036846;2015-06-22;CLI00274;FACTURA;10;1;49432;9392;58824
FAC0036847;2015-08-02;CLI00210;FACTURA;36;1;83127;15794;98921
FAC0036848;2015-12-23;CLI00784;FACTURA;25;1;22873;4346;27219
FAC0036849;2015-08-15;CLI00552;FACTURA;5;1;95718;18186;113904
FAC0036850;2015-11-23;CLI00103;FACTURA;28;2;91492;17383;108875
FAC0036851;2015-02-09;CLI00975;FACTURA;20;2;96210;18280;114490
FAC0036852;2015-07-30;CLI00250;FACTURA;35;1;8448;1605;10053
FAC0036853;2015-04-25;CLI00383;FACTURA;9;2;265830;50508;316338
FAC0036854;2015-12-11;CLI00570;FACTURA;19;1;56380;10712;67092
FAC0036855;2015-12-19;CLI00189;FACTURA;15;2;172676;32808;205484
FAC0036856;2015-01-30;CLI00118;FACTURA;28;1;87009;16532;103541
FAC0036857;2015-04-17;CLI00525;FACTURA;39;2;104790;19910;124700
FAC0036858;2015-01-05;CLI00298;FACTURA;45;1;95718;18186;113904
FAC0036859;2015-09-06;CLI00242;FACTURA;26;1;95718;18186;113904
FAC0036860;2015-12-20;CLI00462;FACTURA;40;1;86004;16341;102345
FAC0036861;2015-05-15;CLI00702;FACTURA;1;1;235179;44684;279863
FAC0036862;2015-08-09;CLI00066;FACTURA;19;1;31437;5973;37410
FAC0036863;2015-09-16;CLI00249;FACTURA;38;2;81168;15422;96590
FAC0036864;2015-04-27;CLI00268;FACTURA;21;1;65577;12460;78037
FAC0036865;2015-06-30;CLI00047;FACTURA;6;2;196904;37412;234316
FAC0036866;2015-01-22;CLI00102;FACTURA;39;1;129088;24527;153615
FAC0036867;2015-09-30;CLI00922;FACTURA;22;1;189497;36004;225501
FAC0036868;2015-01-25;CLI00046;FACTURA;47;1;22552;4285;26837
FAC0036869;2015-11-13;CLI00722;FACTURA;29;1;171048;32499;203547
FAC0036870;2015-05-07;CLI00142;FACTURA;7;1;30603;5815;36418
FAC0036871;2015-12-26;CLI00810;FACTURA;4;1;104412;19838;124250
FAC0036872;2015-07-28;CLI00617;FACTURA;36;2;20402;3876;24278
FAC0036873;2015-06-14;CLI00458;FACTURA;3;1;222012;42182;264194
FAC0036874;2015-03-19;CLI00973;FACTURA;7;2;190053;36110;226163
FAC0036875;2015-10-30;CLI00938;FACTURA;7;1;100735;19140;119875
FAC0036876;2015-07-25;CLI00267;FACTURA;30;2;105585;20061;125646
FAC0036877;2015-07-02;CLI00411;FACTURA;41;2;138840;26380;165220
FAC0036878;2015-01-31;CLI00871;FACTURA;6;2;116012;22042;138054
FAC0036879;2015-04-25;CLI00820;FACTURA;6;1;140555;26705;167260
FAC0036880;2015-11-29;CLI00294;FACTURA;42;1;140555;26705;167260
FAC0036881;2015-03-17;CLI00896;FACTURA;20;1;39730;7549;47279
FAC0036882;2015-02-04;CLI00718;FACTURA;36;1;71502;13585;85087
FAC0036883;2015-06-26;CLI00773;FACTURA;23;2;114540;21763;136303
FAC0036884;2015-01-12;CLI00745;FACTURA;11;2;123065;23382;146447
FAC0036885;2015-09-03;CLI00820;FACTURA;20;1;87436;16613;104049
FAC0036886;2015-08-01;CLI00372;FACTURA;44;1;66381;12612;78993
FAC0036887;2015-05-09;CLI00721;FACTURA;38;2;142401;27056;169457
FAC0036888;2015-07-05;CLI00455;FACTURA;42;2;80680;15329;96009
FAC0036889;2015-10-10;CLI00928;FACTURA;7;1;100735;19140;119875
FAC0036890;2015-10-13;CLI00485;FACTURA;41;2;56380;10712;67092
FAC0036891;2015-09-22;CLI00142;FACTURA;24;1;100338;19064;119402
FAC0036892;2015-11-23;CLI00957;FACTURA;2;2;270710;51435;322145
FAC0036893;2015-11-07;CLI00474;FACTURA;13;1;173550;32975;206525
FAC0036894;2015-11-16;CLI00072;FACTURA;5;1;145224;27593;172817
FAC0036895;2015-06-29;CLI00940;FACTURA;48;1;190053;36110;226163
FAC0036896;2015-04-29;CLI00562;FACTURA;42;1;40804;7753;48557
FAC0036897;2015-03-07;CLI00875;FACTURA;40;2;81729;15529;97258
FAC0036898;2015-04-25;CLI00715;FACTURA;47;2;84468;16049;100517
FAC0036899;2015-06-08;CLI00658;FACTURA;47;1;138545;26324;164869
FAC0036900;2015-05-20;CLI00294;FACTURA;3;1;163458;31057;194515
FAC0036901;2015-09-23;CLI00714;FACTURA;10;1;87009;16532;103541
FAC0036902;2015-04-26;CLI00060;FACTURA;8;1;142540;27083;169623
FAC0036903;2015-05-29;CLI00821;FACTURA;29;2;59136;11236;70372
FAC0036904;2015-08-19;CLI00813;FACTURA;3;2;33828;6427;40255
FAC0036905;2015-06-03;CLI00601;FACTURA;6;2;221672;42118;263790
FAC0036906;2015-05-21;CLI00047;FACTURA;47;2;239247;45457;284704
FAC0036907;2015-08-20;CLI00624;FACTURA;15;1;181112;34411;215523
FAC0036908;2015-07-08;CLI00021;FACTURA;10;2;101624;19309;120933
FAC0036909;2015-04-21;CLI00171;FACTURA;20;2;62874;11946;74820
FAC0036910;2015-03-30;CLI00296;FACTURA;23;1;126582;24051;150633
FAC0036911;2015-12-26;CLI00270;FACTURA;21;1;28668;5447;34115
FAC0036912;2015-05-04;CLI00086;FACTURA;48;1;235179;44684;279863
FAC0036913;2015-08-10;CLI00589;FACTURA;24;2;37932;7207;45139
FAC0036914;2015-02-22;CLI00274;FACTURA;28;1;133236;25315;158551
FAC0036915;2015-07-02;CLI00938;FACTURA;3;1;135834;25808;161642
FAC0036916;2015-04-20;CLI00494;FACTURA;5;1;32070;6093;38163
FAC0036917;2015-03-29;CLI00154;FACTURA;15;1;16914;3214;20128
FAC0036918;2015-11-13;CLI00173;FACTURA;3;2;42234;8024;50258
FAC0036919;2015-01-25;CLI00936;FACTURA;26;1;28508;5417;33925
FAC0036920;2015-11-20;CLI00515;FACTURA;18;2;177842;33790;211632
FAC0036921;2015-08-01;CLI00820;FACTURA;22;1;37784;7179;44963
FAC0036922;2015-02-05;CLI00752;FACTURA;5;1;139216;26451;165667
FAC0036923;2015-05-16;CLI00931;FACTURA;14;2;39466;7499;46965
FAC0036924;2015-07-24;CLI00798;FACTURA;24;1;228654;43444;272098
FAC0036925;2015-04-06;CLI00056;FACTURA;28;1;211170;40122;251292
FAC0036926;2015-05-20;CLI00568;FACTURA;3;1;109025;20715;129740
FAC0036927;2015-10-05;CLI00512;FACTURA;43;1;221517;42088;263605
FAC0036928;2015-06-30;CLI00207;FACTURA;49;2;95718;18186;113904
FAC0036929;2015-05-08;CLI00503;FACTURA;47;2;265830;50508;316338
FAC0036930;2015-11-28;CLI00220;FACTURA;47;1;25406;4827;30233
FAC0036931;2015-12-19;CLI00403;FACTURA;8;2;242970;46164;289134
FAC0036932;2015-11-15;CLI00481;FACTURA;49;2;196777;37388;234165
FAC0036933;2015-04-23;CLI00403;FACTURA;9;2;245187;46586;291773
FAC0036934;2015-10-19;CLI00198;FACTURA;29;1;88180;16754;104934
FAC0036935;2015-07-11;CLI00354;FACTURA;41;1;197344;37495;234839
FAC0036936;2015-10-31;CLI00486;FACTURA;8;1;135355;25717;161072
FAC0036937;2015-11-07;CLI00961;FACTURA;3;2;196731;37379;234110
FAC0036938;2015-10-19;CLI00359;FACTURA;2;2;277090;52647;329737
FAC0036939;2015-10-16;CLI00686;FACTURA;50;1;98452;18706;117158
FAC0036940;2015-03-01;CLI00950;FACTURA;50;1;18510;3517;22027
FAC0036941;2015-08-27;CLI00464;FACTURA;24;1;174020;33064;207084
FAC0036942;2015-03-18;CLI00902;FACTURA;32;1;196245;37287;233532
FAC0036943;2015-06-09;CLI00482;FACTURA;10;1;21097;4008;25105
FAC0036944;2015-12-15;CLI00906;FACTURA;46;1;136740;25981;162721
FAC0036945;2015-02-05;CLI00490;FACTURA;15;1;24613;4676;29289
FAC0036946;2015-03-24;CLI00102;FACTURA;20;1;153013;29072;182085
FAC0036947;2015-01-21;CLI00166;FACTURA;8;1;22552;4285;26837
FAC0036948;2015-10-21;CLI00274;FACTURA;25;1;22908;4353;27261
FAC0036949;2015-11-08;CLI00209;FACTURA;49;2;20958;3982;24940
FAC0036950;2015-07-22;CLI00934;FACTURA;2;1;151176;28723;179899
FAC0036951;2015-10-14;CLI00189;FACTURA;8;2;29003;5511;34514
FAC0036952;2015-04-28;CLI00005;FACTURA;15;2;24668;4687;29355
FAC0036953;2015-12-24;CLI00006;FACTURA;17;1;132915;25254;158169
FAC0036954;2015-12-04;CLI00206;FACTURA;9;1;68370;12990;81360
FAC0036955;2015-09-11;CLI00572;FACTURA;13;1;111030;21096;132126
FAC0036956;2015-11-13;CLI00986;FACTURA;24;1;105585;20061;125646
FAC0036957;2015-01-30;CLI00096;FACTURA;17;1;50688;9631;60319
FAC0036958;2015-02-01;CLI00323;FACTURA;38;2;91632;17410;109042
FAC0036959;2015-04-05;CLI00778;FACTURA;16;1;54486;10352;64838
FAC0036960;2015-03-08;CLI00015;FACTURA;48;2;137238;26075;163313
FAC0036961;2015-10-28;CLI00572;FACTURA;39;1;243639;46291;289930
FAC0036962;2015-11-25;CLI00302;FACTURA;41;1;87220;16572;103792
FAC0036963;2015-05-01;CLI00089;FACTURA;10;2;65532;12451;77983
FAC0036964;2015-01-05;CLI00729;FACTURA;46;2;64140;12187;76327
FAC0036965;2015-02-11;CLI00045;FACTURA;17;2;24716;4696;29412
FAC0036966;2015-10-14;CLI00116;FACTURA;13;1;197344;37495;234839
FAC0036967;2015-11-04;CLI00769;FACTURA;36;2;18897;3590;22487
FAC0036968;2015-07-01;CLI00323;FACTURA;8;2;39730;7549;47279
FAC0036969;2015-12-21;CLI00278;FACTURA;9;1;249381;47382;296763
FAC0036970;2015-10-03;CLI00685;FACTURA;18;2;313236;59515;372751
FAC0036971;2015-05-07;CLI00767;FACTURA;35;2;203021;38574;241595
FAC0036972;2015-06-09;CLI00520;FACTURA;39;1;28111;5341;33452
FAC0036973;2015-07-04;CLI00309;FACTURA;23;2;9483;1802;11285
FAC0036974;2015-12-24;CLI00818;FACTURA;31;1;199854;37972;237826
FAC0036975;2015-02-26;CLI00231;FACTURA;28;2;152298;28937;181235
FAC0036976;2015-06-17;CLI00739;FACTURA;44;2;27709;5265;32974
FAC0036977;2015-09-08;CLI00104;FACTURA;9;1;96816;18395;115211
FAC0036978;2015-08-28;CLI00565;FACTURA;7;2;27709;5265;32974
FAC0036979;2015-03-17;CLI00851;FACTURA;49;2;189873;36076;225949
FAC0036980;2015-01-27;CLI00974;FACTURA;39;1;116012;22042;138054
FAC0036981;2015-02-02;CLI00258;FACTURA;27;1;91492;17383;108875
FAC0036982;2015-11-25;CLI00085;FACTURA;4;2;42194;8017;50211
FAC0036983;2015-03-11;CLI00691;FACTURA;26;2;61029;11596;72625
FAC0036984;2015-01-15;CLI00230;FACTURA;23;1;85640;16272;101912
FAC0036985;2015-03-17;CLI00942;FACTURA;46;1;221517;42088;263605
FAC0036986;2015-04-17;CLI00828;FACTURA;12;1;37784;7179;44963
FAC0036987;2015-08-06;CLI00816;FACTURA;49;1;129006;24511;153517
FAC0036988;2015-05-18;CLI00299;FACTURA;13;2;221517;42088;263605
FAC0036989;2015-02-24;CLI00909;FACTURA;3;2;113382;21543;134925
FAC0036990;2015-03-01;CLI00392;FACTURA;14;1;139216;26451;165667
FAC0036991;2015-10-26;CLI00608;FACTURA;43;1;78024;14825;92849
FAC0036992;2015-11-26;CLI00887;FACTURA;41;2;22639;4301;26940
FAC0036993;2015-10-18;CLI00020;FACTURA;18;1;174872;33226;208098
FAC0036994;2015-03-17;CLI00264;FACTURA;39;1;117036;22237;139273
FAC0036995;2015-01-02;CLI00447;FACTURA;42;2;101892;19359;121251
FAC0036996;2015-05-19;CLI00327;FACTURA;1;2;218050;41430;259480
FAC0036997;2015-09-28;CLI00745;FACTURA;26;2;11454;2176;13630
FAC0036998;2015-02-26;CLI00961;FACTURA;44;2;294894;56030;350924
FAC0036999;2015-07-16;CLI00891;FACTURA;27;2;23834;4528;28362
FAC0037000;2015-11-13;CLI00939;FACTURA;4;2;118454;22506;140960
FAC0037001;2015-05-01;CLI00824;FACTURA;9;1;149870;28475;178345
FAC0037002;2015-01-13;CLI00153;FACTURA;8;2;239309;45469;284778
FAC0037003;2015-08-23;CLI00849;FACTURA;2;2;71502;13585;85087
FAC0037004;2015-03-06;CLI00973;FACTURA;6;2;228730;43459;272189
FAC0037005;2015-08-17;CLI00973;FACTURA;37;2;106332;20203;126535
FAC0037006;2015-08-06;CLI00322;FACTURA;10;1;37020;7034;44054
FAC0037007;2015-02-19;CLI00604;FACTURA;21;1;41022;7794;48816
FAC0037008;2015-03-02;CLI00980;FACTURA;17;1;39012;7412;46424
FAC0037009;2015-06-13;CLI00339;FACTURA;8;2;18897;3590;22487
FAC0037010;2015-07-07;CLI00364;FACTURA;13;1;31437;5973;37410
FAC0037011;2015-04-21;CLI00365;FACTURA;21;2;54142;10287;64429
FAC0037012;2015-05-04;CLI00883;FACTURA;29;2;208260;39569;247829
FAC0037013;2015-03-17;CLI00854;FACTURA;45;1;114032;21666;135698
FAC0037014;2015-01-30;CLI00344;FACTURA;26;1;203784;38719;242503
FAC0037015;2015-01-02;CLI00168;FACTURA;40;1;159498;30305;189803
FAC0037016;2015-09-11;CLI00190;FACTURA;27;1;47230;8974;56204
FAC0037017;2015-11-27;CLI00718;FACTURA;28;1;98298;18677;116975
FAC0037018;2015-08-01;CLI00378;FACTURA;14;1;67194;12767;79961
FAC0037019;2015-07-28;CLI00955;FACTURA;23;2;56898;10811;67709
FAC0037020;2015-01-03;CLI00591;FACTURA;8;2;24680;4689;29369
FAC0037021;2015-10-21;CLI00136;FACTURA;38;1;20292;3855;24147
FAC0037022;2015-02-14;CLI00412;FACTURA;5;1;94830;18018;112848
FAC0037023;2015-02-15;CLI00638;FACTURA;7;1;205857;39113;244970
FAC0037024;2015-02-13;CLI00790;FACTURA;19;1;114672;21788;136460
FAC0037025;2015-12-22;CLI00745;FACTURA;3;2;218590;41532;260122
FAC0037026;2015-07-03;CLI00148;FACTURA;45;1;101624;19309;120933
FAC0037027;2015-03-10;CLI00539;FACTURA;41;2;205857;39113;244970
FAC0037028;2015-04-01;CLI00821;FACTURA;23;2;23838;4529;28367
FAC0037029;2015-01-31;CLI00347;FACTURA;7;2;348040;66128;414168
FAC0037030;2015-03-11;CLI00750;FACTURA;33;1;47230;8974;56204
FAC0037031;2015-04-21;CLI00373;FACTURA;45;2;37794;7181;44975
FAC0037032;2015-10-11;CLI00550;FACTURA;19;1;57336;10894;68230
FAC0037033;2015-10-13;CLI00615;FACTURA;5;2;61029;11596;72625
FAC0037034;2015-12-20;CLI00535;FACTURA;8;2;170073;32314;202387
FAC0037035;2015-01-11;CLI00132;FACTURA;1;1;17636;3351;20987
FAC0037036;2015-04-30;CLI00145;FACTURA;6;2;29003;5511;34514
FAC0037037;2015-01-28;CLI00072;FACTURA;27;1;177842;33790;211632
FAC0037038;2015-11-04;CLI00266;FACTURA;18;1;218590;41532;260122
FAC0037039;2015-05-04;CLI00496;FACTURA;48;1;25344;4815;30159
FAC0037040;2015-04-07;CLI00445;FACTURA;30;2;132279;25133;157412
FAC0037041;2015-11-11;CLI00257;FACTURA;29;2;197344;37495;234839
FAC0037042;2015-06-14;CLI00526;FACTURA;11;1;160111;30421;190532
FAC0037043;2015-05-21;CLI00234;FACTURA;16;1;168666;32047;200713
FAC0037044;2015-03-16;CLI00839;FACTURA;27;2;172291;32735;205026
FAC0037045;2015-06-28;CLI00594;FACTURA;35;1;163458;31057;194515
FAC0037046;2015-05-13;CLI00142;FACTURA;24;1;136542;25943;162485
FAC0037047;2015-02-25;CLI00853;FACTURA;47;2;56222;10682;66904
FAC0037048;2015-10-03;CLI00070;FACTURA;6;1;127030;24136;151166
FAC0037049;2015-06-26;CLI00082;FACTURA;4;1;74004;14061;88065
FAC0037050;2015-07-23;CLI00432;FACTURA;49;1;151788;28840;180628
FAC0037051;2015-05-08;CLI00020;FACTURA;36;1;189873;36076;225949
FAC0037052;2015-10-06;CLI00378;FACTURA;38;1;168666;32047;200713
FAC0037053;2015-11-07;CLI00994;FACTURA;30;1;70544;13403;83947
FAC0037054;2015-07-20;CLI00183;FACTURA;23;2;24716;4696;29412
FAC0037055;2015-02-27;CLI00187;FACTURA;40;2;22206;4219;26425
FAC0037056;2015-06-18;CLI00430;FACTURA;31;1;22206;4219;26425
FAC0037057;2015-06-22;CLI00251;FACTURA;44;2;65415;12429;77844
FAC0037058;2015-04-27;CLI00201;FACTURA;26;2;84610;16076;100686
FAC0037059;2015-07-23;CLI00104;FACTURA;6;1;50812;9654;60466
FAC0037060;2015-09-18;CLI00861;FACTURA;22;2;166254;31588;197842
FAC0037061;2015-09-22;CLI00518;FACTURA;18;1;172676;32808;205484
FAC0037062;2015-09-16;CLI00951;FACTURA;26;2;140555;26705;167260
FAC0037063;2015-01-07;CLI00312;FACTURA;13;1;113382;21543;134925
FAC0037064;2015-05-29;CLI00384;FACTURA;11;1;20343;3865;24208
FAC0037065;2015-01-25;CLI00729;FACTURA;46;2;246130;46765;292895
FAC0037066;2015-08-07;CLI00862;FACTURA;38;1;131064;24902;155966
FAC0037067;2015-06-25;CLI00348;FACTURA;8;1;243639;46291;289930
FAC0037068;2015-03-22;CLI00622;FACTURA;23;1;47668;9057;56725
FAC0037069;2015-04-26;CLI00151;FACTURA;21;2;69608;13226;82834
FAC0037070;2015-12-09;CLI00586;FACTURA;31;1;177842;33790;211632
FAC0037071;2015-09-12;CLI00321;FACTURA;8;2;64140;12187;76327
FAC0037072;2015-12-24;CLI00433;FACTURA;4;2;49336;9374;58710
FAC0037073;2015-02-23;CLI00481;FACTURA;41;2;50596;9613;60209
FAC0037074;2015-02-26;CLI00997;FACTURA;23;2;21410;4068;25478
FAC0037075;2015-05-06;CLI00963;FACTURA;2;2;56898;10811;67709
FAC0037076;2015-09-25;CLI00304;FACTURA;46;1;10146;1928;12074
FAC0037077;2015-10-28;CLI00626;FACTURA;1;1;272430;51762;324192
FAC0037078;2015-03-29;CLI00726;FACTURA;1;1;335970;63834;399804
FAC0037079;2015-07-28;CLI00868;FACTURA;34;1;108284;20574;128858
FAC0037080;2015-08-17;CLI00875;FACTURA;15;2;90556;17206;107762
FAC0037081;2015-02-04;CLI00713;FACTURA;11;2;90556;17206;107762
FAC0037082;2015-01-21;CLI00948;FACTURA;7;1;128460;24407;152867
FAC0037083;2015-03-05;CLI00025;FACTURA;1;2;20402;3876;24278
FAC0037084;2015-08-13;CLI00467;FACTURA;31;2;105485;20042;125527
FAC0037085;2015-09-15;CLI00120;FACTURA;22;1;171280;32543;203823
FAC0037086;2015-04-08;CLI00213;FACTURA;28;2;59585;11321;70906
FAC0037087;2015-11-03;CLI00312;FACTURA;48;1;42234;8024;50258
FAC0037088;2015-12-18;CLI00761;FACTURA;38;2;222012;42182;264194
FAC0037089;2015-08-08;CLI00633;FACTURA;39;2;110836;21059;131895
FAC0037090;2015-09-07;CLI00695;FACTURA;34;2;50688;9631;60319
FAC0037091;2015-04-25;CLI00427;FACTURA;44;2;131064;24902;155966
FAC0037092;2015-02-19;CLI00066;FACTURA;26;1;76032;14446;90478
FAC0037093;2015-02-12;CLI00270;FACTURA;39;1;47668;9057;56725
FAC0037094;2015-12-28;CLI00283;FACTURA;40;2;105816;20105;125921
FAC0037095;2015-06-30;CLI00088;FACTURA;49;1;348040;66128;414168
FAC0037096;2015-03-19;CLI00020;FACTURA;49;1;203021;38574;241595
FAC0037097;2015-10-05;CLI00094;FACTURA;3;1;45746;8692;54438
FAC0037098;2015-11-11;CLI00999;FACTURA;42;2;193963;36853;230816
FAC0037099;2015-05-27;CLI00345;FACTURA;31;2;82044;15588;97632
FAC0037100;2015-02-04;CLI00511;FACTURA;13;2;136542;25943;162485
FAC0037101;2015-01-23;CLI00406;FACTURA;20;1;272430;51762;324192
FAC0037102;2015-10-18;CLI00148;FACTURA;22;1;104412;19838;124250
FAC0037103;2015-09-01;CLI00984;FACTURA;35;1;27709;5265;32974
FAC0037104;2015-09-04;CLI00231;FACTURA;2;2;20292;3855;24147
FAC0037105;2015-09-18;CLI00230;FACTURA;40;1;55622;10568;66190
FAC0037106;2015-11-03;CLI00155;FACTURA;47;2;126582;24051;150633
FAC0037107;2015-08-09;CLI00061;FACTURA;39;2;249381;47382;296763
FAC0037108;2015-05-21;CLI00751;FACTURA;27;2;56380;10712;67092
FAC0037109;2015-10-16;CLI00524;FACTURA;37;1;83419;15850;99269
FAC0037110;2015-01-09;CLI00199;FACTURA;37;2;109392;20784;130176
FAC0037111;2015-03-18;CLI00591;FACTURA;6;2;254060;48271;302331
FAC0037112;2015-07-24;CLI00751;FACTURA;7;2;30603;5815;36418
FAC0037113;2015-03-20;CLI00514;FACTURA;5;1;45746;8692;54438
FAC0037114;2015-11-26;CLI00048;FACTURA;32;1;152635;29001;181636
FAC0037115;2015-05-04;CLI00103;FACTURA;46;2;8448;1605;10053
FAC0037116;2015-01-15;CLI00843;FACTURA;24;2;58006;11021;69027
FAC0037117;2015-04-13;CLI00527;FACTURA;21;2;88180;16754;104934
FAC0037118;2015-11-13;CLI00961;FACTURA;9;2;81213;15430;96643
FAC0037119;2015-03-28;CLI00436;FACTURA;37;1;34362;6529;40891
FAC0037120;2015-10-20;CLI00161;FACTURA;17;2;120882;22968;143850
FAC0037121;2015-11-08;CLI00126;FACTURA;10;1;208824;39677;248501
FAC0037122;2015-02-10;CLI00094;FACTURA;38;1;112952;21461;134413
FAC0037123;2015-02-14;CLI00905;FACTURA;26;2;16136;3066;19202
FAC0037124;2015-10-08;CLI00350;FACTURA;21;1;122058;23191;145249
FAC0037125;2015-02-27;CLI00146;FACTURA;35;1;54486;10352;64838
FAC0037126;2015-06-01;CLI00634;FACTURA;33;1;26583;5051;31634
FAC0037127;2015-01-25;CLI00450;FACTURA;4;1;137238;26075;163313
FAC0037128;2015-10-11;CLI00529;FACTURA;27;2;142401;27056;169457
FAC0037129;2015-09-29;CLI00814;FACTURA;14;1;30438;5783;36221
FAC0037130;2015-09-06;CLI00674;FACTURA;36;1;13674;2598;16272
FAC0037131;2015-10-04;CLI00469;FACTURA;24;2;50946;9680;60626
FAC0037132;2015-08-09;CLI00584;FACTURA;44;1;151788;28840;180628
FAC0037133;2015-08-10;CLI00076;FACTURA;7;1;47676;9058;56734
FAC0037134;2015-06-07;CLI00572;FACTURA;11;1;71514;13588;85102
FAC0037135;2015-11-05;CLI00704;FACTURA;36;1;95336;18114;113450
FAC0037136;2015-12-22;CLI00655;FACTURA;14;2;136542;25943;162485
FAC0037137;2015-11-28;CLI00848;FACTURA;4;1;172676;32808;205484
FAC0037138;2015-10-12;CLI00836;FACTURA;30;1;26583;5051;31634
FAC0037139;2015-09-14;CLI00333;FACTURA;2;2;170073;32314;202387
FAC0037140;2015-04-08;CLI00875;FACTURA;5;2;147679;28059;175738
FAC0037141;2015-12-25;CLI00637;FACTURA;2;2;137238;26075;163313
FAC0037142;2015-02-05;CLI00468;FACTURA;24;1;59585;11321;70906
FAC0037143;2015-10-13;CLI00456;FACTURA;5;1;16914;3214;20128
FAC0037144;2015-01-30;CLI00826;FACTURA;35;1;268776;51067;319843
FAC0037145;2015-12-04;CLI00322;FACTURA;4;1;190053;36110;226163
FAC0037146;2015-11-14;CLI00300;FACTURA;41;1;21117;4012;25129
FAC0037147;2015-05-01;CLI00711;FACTURA;22;2;42234;8024;50258
FAC0037148;2015-07-08;CLI00756;FACTURA;45;1;130830;24858;155688
FAC0037149;2015-09-28;CLI00069;FACTURA;4;2;80175;15233;95408
FAC0037150;2015-10-26;CLI00498;FACTURA;9;1;105485;20042;125527
FAC0037151;2015-03-21;CLI00219;FACTURA;29;2;49360;9378;58738
FAC0037152;2015-01-13;CLI00486;FACTURA;4;1;222060;42191;264251
FAC0037153;2015-01-26;CLI00848;FACTURA;26;1;138545;26324;164869
FAC0037154;2015-04-12;CLI00246;FACTURA;48;1;34187;6496;40683
FAC0037155;2015-06-27;CLI00500;FACTURA;31;1;166254;31588;197842
FAC0037156;2015-10-10;CLI00667;FACTURA;7;2;120882;22968;143850
FAC0037157;2015-10-18;CLI00701;FACTURA;12;2;35751;6793;42544
FAC0037158;2015-10-09;CLI00891;FACTURA;49;2;111030;21096;132126
FAC0037159;2015-02-02;CLI00760;FACTURA;47;1;47676;9058;56734
FAC0037160;2015-10-11;CLI00972;FACTURA;22;1;24680;4689;29369
FAC0037161;2015-07-01;CLI00591;FACTURA;4;2;210970;40084;251054
FAC0037162;2015-10-27;CLI00980;FACTURA;30;1;42234;8024;50258
FAC0037163;2015-03-02;CLI00378;FACTURA;21;1;75568;14358;89926
FAC0037164;2015-06-21;CLI00889;FACTURA;16;2;25298;4807;30105
FAC0037165;2015-11-01;CLI00975;FACTURA;48;2;196777;37388;234165
FAC0037166;2015-11-19;CLI00723;FACTURA;14;2;16922;3215;20137
FAC0037167;2015-08-30;CLI00082;FACTURA;10;1;174872;33226;208098
FAC0037168;2015-08-22;CLI00579;FACTURA;5;2;62874;11946;74820
FAC0037169;2015-02-06;CLI00926;FACTURA;25;1;151176;28723;179899
FAC0037170;2015-12-09;CLI00780;FACTURA;30;1;69420;13190;82610
FAC0037171;2015-11-17;CLI00529;FACTURA;16;2;174440;33144;207584
FAC0037172;2015-04-09;CLI00097;FACTURA;25;2;59136;11236;70372
FAC0037173;2015-09-14;CLI00532;FACTURA;44;1;11917;2264;14181
FAC0037174;2015-02-26;CLI00859;FACTURA;35;2;281110;53411;334521
FAC0037175;2015-01-07;CLI00784;FACTURA;17;1;131154;24919;156073
FAC0037176;2015-01-25;CLI00001;FACTURA;31;2;141088;26807;167895
FAC0037177;2015-01-14;CLI00733;FACTURA;3;2;40584;7711;48295
FAC0037178;2015-02-15;CLI00616;FACTURA;41;1;127030;24136;151166
FAC0037179;2015-08-29;CLI00549;FACTURA;4;2;21117;4012;25129
FAC0037180;2015-08-12;CLI00986;FACTURA;27;1;59585;11321;70906
FAC0037181;2015-10-29;CLI00712;FACTURA;45;1;228064;43332;271396
FAC0037182;2015-02-26;CLI00575;FACTURA;28;2;169220;32152;201372
FAC0037183;2015-05-16;CLI00813;FACTURA;42;2;43718;8306;52024
FAC0037184;2015-06-03;CLI00677;FACTURA;39;2;98672;18748;117420
FAC0037185;2015-04-28;CLI00362;FACTURA;41;1;20402;3876;24278
FAC0037186;2015-10-20;CLI00562;FACTURA;7;1;169220;32152;201372
FAC0037187;2015-07-15;CLI00977;FACTURA;7;2;37932;7207;45139
FAC0037188;2015-08-18;CLI00893;FACTURA;46;2;108972;20705;129677
FAC0037189;2015-12-12;CLI00650;FACTURA;50;1;90556;17206;107762
FAC0037190;2015-05-02;CLI00303;FACTURA;41;2;132915;25254;158169
FAC0037191;2015-10-04;CLI00832;FACTURA;46;1;232024;44085;276109
FAC0037192;2015-09-25;CLI00243;FACTURA;5;2;153013;29072;182085
FAC0037193;2015-09-05;CLI00539;FACTURA;19;2;105585;20061;125646
FAC0037194;2015-08-21;CLI00044;FACTURA;29;1;134388;25534;159922
FAC0037195;2015-04-03;CLI00604;FACTURA;11;1;21859;4153;26012
FAC0037196;2015-02-01;CLI00070;FACTURA;33;1;145015;27553;172568
FAC0037197;2015-02-12;CLI00033;FACTURA;49;2;25298;4807;30105
FAC0037198;2015-02-05;CLI00319;FACTURA;11;2;33792;6420;40212
FAC0037199;2015-06-14;CLI00635;FACTURA;16;2;101460;19277;120737
FAC0037200;2015-07-13;CLI00460;FACTURA;15;1;218590;41532;260122
FAC0037201;2015-01-24;CLI00155;FACTURA;32;2;142540;27083;169623
FAC0037202;2015-07-30;CLI00171;FACTURA;13;2;68724;13058;81782
FAC0037203;2015-08-22;CLI00456;FACTURA;12;1;171048;32499;203547
FAC0037204;2015-05-13;CLI00431;FACTURA;20;2;131064;24902;155966
FAC0037205;2015-12-19;CLI00164;FACTURA;47;1;227682;43260;270942
FAC0037206;2015-01-18;CLI00595;FACTURA;8;2;50596;9613;60209
FAC0037207;2015-06-16;CLI00733;FACTURA;19;2;142540;27083;169623
FAC0037208;2015-03-20;CLI00133;FACTURA;38;2;135355;25717;161072
FAC0037209;2015-11-08;CLI00680;FACTURA;5;1;56691;10771;67462
FAC0037210;2015-01-11;CLI00665;FACTURA;17;2;21117;4012;25129
FAC0037211;2015-08-24;CLI00470;FACTURA;44;1;25473;4840;30313
FAC0037212;2015-10-13;CLI00005;FACTURA;18;2;100735;19140;119875
FAC0037213;2015-03-20;CLI00590;FACTURA;17;1;71514;13588;85102
FAC0037214;2015-03-18;CLI00554;FACTURA;23;1;18510;3517;22027
FAC0037215;2015-07-12;CLI00328;FACTURA;9;1;96816;18395;115211
FAC0037216;2015-05-29;CLI00681;FACTURA;31;2;138840;26380;165220
FAC0037217;2015-05-11;CLI00983;FACTURA;30;2;102561;19487;122048
FAC0037218;2015-12-11;CLI00430;FACTURA;19;1;130830;24858;155688
FAC0037219;2015-03-10;CLI00122;FACTURA;1;1;109295;20766;130061
FAC0037220;2015-08-06;CLI00372;FACTURA;3;1;290030;55106;345136
FAC0037221;2015-09-30;CLI00868;FACTURA;29;1;18897;3590;22487
FAC0037222;2015-11-29;CLI00045;FACTURA;20;2;245187;46586;291773
FAC0037223;2015-01-14;CLI00504;FACTURA;24;1;228654;43444;272098
FAC0037224;2015-05-19;CLI00506;FACTURA;15;1;104130;19785;123915
FAC0037225;2015-07-22;CLI00162;FACTURA;19;1;84333;16023;100356
FAC0037226;2015-09-02;CLI00737;FACTURA;22;2;8448;1605;10053
FAC0037227;2015-09-19;CLI00361;FACTURA;3;2;76218;14481;90699
FAC0037228;2015-01-06;CLI00456;FACTURA;10;1;114540;21763;136303
FAC0037229;2015-01-23;CLI00946;FACTURA;2;1;135376;25721;161097
FAC0037230;2015-11-11;CLI00563;FACTURA;3;2;256572;48749;305321
FAC0037231;2015-04-12;CLI00102;FACTURA;19;1;25473;4840;30313
FAC0037232;2015-03-29;CLI00066;FACTURA;43;1;114365;21729;136094
FAC0037233;2015-06-26;CLI00751;FACTURA;49;2;42234;8024;50258
FAC0037234;2015-03-05;CLI00393;FACTURA;36;2;12340;2345;14685
FAC0037235;2015-09-19;CLI00901;FACTURA;3;2;22908;4353;27261
FAC0037236;2015-12-22;CLI00005;FACTURA;21;2;42240;8026;50266
FAC0037237;2015-04-27;CLI00890;FACTURA;36;1;43610;8286;51896
FAC0037238;2015-07-04;CLI00125;FACTURA;9;2;96816;18395;115211
FAC0037239;2015-06-04;CLI00173;FACTURA;47;2;101532;19291;120823
FAC0037240;2015-07-17;CLI00161;FACTURA;5;2;87220;16572;103792
FAC0037241;2015-04-08;CLI00087;FACTURA;13;2;33828;6427;40255
FAC0037242;2015-07-08;CLI00979;FACTURA;42;2;127030;24136;151166
FAC0037243;2015-04-11;CLI00346;FACTURA;24;1;35272;6702;41974
FAC0037244;2015-08-01;CLI00048;FACTURA;45;1;110836;21059;131895
FAC0037245;2015-03-01;CLI00476;FACTURA;24;1;84610;16076;100686
FAC0037246;2015-12-14;CLI00212;FACTURA;37;1;87220;16572;103792
FAC0037247;2015-07-11;CLI00273;FACTURA;35;2;112245;21327;133572
FAC0037248;2015-11-23;CLI00610;FACTURA;50;1;22206;4219;26425
FAC0037249;2015-09-02;CLI00112;FACTURA;36;1;45816;8705;54521
FAC0037250;2015-07-15;CLI00888;FACTURA;5;1;23834;4528;28362
FAC0037251;2015-05-13;CLI00913;FACTURA;30;2;65577;12460;78037
FAC0037252;2015-03-14;CLI00738;FACTURA;7;1;174018;33063;207081
FAC0037253;2015-10-04;CLI00695;FACTURA;27;2;91632;17410;109042
FAC0037254;2015-10-30;CLI00884;FACTURA;13;1;24613;4676;29289
FAC0037255;2015-10-07;CLI00461;FACTURA;27;2;285080;54165;339245
FAC0037256;2015-07-19;CLI00125;FACTURA;33;2;110836;21059;131895
FAC0037257;2015-11-07;CLI00609;FACTURA;15;2;196777;37388;234165
FAC0037258;2015-04-21;CLI00413;FACTURA;12;2;167985;31917;199902
FAC0037259;2015-05-08;CLI00517;FACTURA;38;2;113382;21543;134925
FAC0037260;2015-08-29;CLI00523;FACTURA;33;2;67688;12861;80549
FAC0037261;2015-06-06;CLI00779;FACTURA;48;2;85014;16153;101167
FAC0037262;2015-03-12;CLI00874;FACTURA;46;1;91809;17444;109253
FAC0037263;2015-02-27;CLI00116;FACTURA;42;1;201582;38301;239883
FAC0037264;2015-04-27;CLI00225;FACTURA;25;2;34710;6595;41305
FAC0037265;2015-12-01;CLI00851;FACTURA;23;2;27071;5143;32214
FAC0037266;2015-04-27;CLI00953;FACTURA;35;2;91632;17410;109042
FAC0037267;2015-10-02;CLI00186;FACTURA;36;1;134388;25534;159922
FAC0037268;2015-12-08;CLI00559;FACTURA;31;2;51005;9691;60696
FAC0037269;2015-08-18;CLI00504;FACTURA;50;1;138545;26324;164869
FAC0037270;2015-06-25;CLI00121;FACTURA;2;2;278432;52902;331334
FAC0037271;2015-05-29;CLI00104;FACTURA;9;1;50766;9646;60412
FAC0037272;2015-04-28;CLI00017;FACTURA;26;2;104790;19910;124700
FAC0037273;2015-12-06;CLI00675;FACTURA;24;2;174872;33226;208098
FAC0037274;2015-11-18;CLI00334;FACTURA;30;1;56898;10811;67709
FAC0037275;2015-02-25;CLI00541;FACTURA;36;2;43190;8206;51396
FAC0037276;2015-08-15;CLI00011;FACTURA;16;2;18897;3590;22487
FAC0037277;2015-08-04;CLI00721;FACTURA;29;2;232024;44085;276109
FAC0037278;2015-11-17;CLI00698;FACTURA;21;1;162744;30921;193665
FAC0037279;2015-09-23;CLI00479;FACTURA;32;2;45104;8570;53674
FAC0037280;2015-09-17;CLI00130;FACTURA;28;1;229257;43559;272816
FAC0037281;2015-04-23;CLI00953;FACTURA;17;2;27348;5196;32544
FAC0037282;2015-06-27;CLI00152;FACTURA;43;1;123066;23383;146449
FAC0037283;2015-09-16;CLI00197;FACTURA;40;2;86004;16341;102345
FAC0037284;2015-08-10;CLI00360;FACTURA;22;1;120882;22968;143850
FAC0037285;2015-01-14;CLI00910;FACTURA;27;1;126582;24051;150633
FAC0037286;2015-04-25;CLI00177;FACTURA;3;2;228654;43444;272098
FAC0037287;2015-11-22;CLI00478;FACTURA;33;1;229362;43579;272941
FAC0037288;2015-03-07;CLI00006;FACTURA;5;1;6170;1172;7342
FAC0037289;2015-03-22;CLI00997;FACTURA;17;2;101624;19309;120933
FAC0037290;2015-01-06;CLI00661;FACTURA;4;2;168776;32067;200843
FAC0037291;2015-08-18;CLI00959;FACTURA;27;2;175554;33355;208909
FAC0037292;2015-09-02;CLI00418;FACTURA;41;1;101892;19359;121251
FAC0037293;2015-11-12;CLI00425;FACTURA;5;2;171280;32543;203823
FAC0037294;2015-05-07;CLI00719;FACTURA;24;2;242970;46164;289134
FAC0037295;2015-10-28;CLI00800;FACTURA;23;1;137238;26075;163313
FAC0037296;2015-09-21;CLI00669;FACTURA;11;2;75864;14414;90278
FAC0037297;2015-02-20;CLI00231;FACTURA;4;2;57016;10833;67849
FAC0037298;2015-01-26;CLI00044;FACTURA;11;1;85524;16250;101774
FAC0037299;2015-06-06;CLI00959;FACTURA;9;2;192690;36611;229301
FAC0037300;2015-08-10;CLI00734;FACTURA;49;1;212664;40406;253070
FAC0037301;2015-08-16;CLI00723;FACTURA;5;2;197344;37495;234839
FAC0037302;2015-03-31;CLI00623;FACTURA;22;2;81372;15461;96833
FAC0037303;2015-08-20;CLI00828;FACTURA;40;1;76218;14481;90699
FAC0037304;2015-05-17;CLI00839;FACTURA;2;2;48408;9198;57606
FAC0037305;2015-12-08;CLI00573;FACTURA;36;2;50812;9654;60466
FAC0037306;2015-11-27;CLI00443;FACTURA;45;2;153013;29072;182085
FAC0037307;2015-08-18;CLI00886;FACTURA;18;1;30895;5870;36765
FAC0037308;2015-05-02;CLI00514;FACTURA;44;1;182984;34767;217751
FAC0037309;2015-11-26;CLI00230;FACTURA;2;1;239247;45457;284704
FAC0037310;2015-10-08;CLI00806;FACTURA;46;1;167985;31917;199902
FAC0037311;2015-11-28;CLI00846;FACTURA;36;1;174872;33226;208098
FAC0037312;2015-04-30;CLI00061;FACTURA;41;2;205122;38973;244095
FAC0037313;2015-09-12;CLI00634;FACTURA;42;1;278432;52902;331334
FAC0037314;2015-07-07;CLI00680;FACTURA;1;1;111030;21096;132126
FAC0037315;2015-06-20;CLI00042;FACTURA;48;1;75588;14362;89950
FAC0037316;2015-09-12;CLI00556;FACTURA;11;1;65532;12451;77983
FAC0037317;2015-10-23;CLI00039;FACTURA;50;2;272430;51762;324192
FAC0037318;2015-12-04;CLI00398;FACTURA;25;1;47676;9058;56734
FAC0037319;2015-02-20;CLI00036;FACTURA;40;1;65532;12451;77983
FAC0037320;2015-02-27;CLI00966;FACTURA;24;1;27071;5143;32214
FAC0037321;2015-09-18;CLI00817;FACTURA;39;2;246130;46765;292895
FAC0037322;2015-07-05;CLI00986;FACTURA;6;1;102010;19382;121392
FAC0037323;2015-04-21;CLI00083;FACTURA;6;2;57336;10894;68230
FAC0037324;2015-11-05;CLI00327;FACTURA;47;2;29003;5511;34514
FAC0037325;2015-10-24;CLI00715;FACTURA;33;2;107253;20378;127631
FAC0037326;2015-05-23;CLI00790;FACTURA;1;1;190053;36110;226163
FAC0037327;2015-06-07;CLI00834;FACTURA;30;1;141088;26807;167895
FAC0037328;2015-01-14;CLI00551;FACTURA;44;2;83832;15928;99760
FAC0037329;2015-07-01;CLI00598;FACTURA;23;1;294894;56030;350924
FAC0037330;2015-05-01;CLI00683;FACTURA;10;2;25406;4827;30233
FAC0037331;2015-08-11;CLI00223;FACTURA;27;2;228654;43444;272098
FAC0037332;2015-07-26;CLI00837;FACTURA;45;2;30438;5783;36221
FAC0037333;2015-05-27;CLI00689;FACTURA;44;2;52908;10053;62961
FAC0037334;2015-08-20;CLI00970;FACTURA;49;1;47230;8974;56204
FAC0037335;2015-11-18;CLI00358;FACTURA;49;1;161360;30658;192018
FAC0037336;2015-07-08;CLI00218;FACTURA;7;1;57016;10833;67849
FAC0037337;2015-11-07;CLI00636;FACTURA;18;1;232024;44085;276109
FAC0037338;2015-06-03;CLI00550;FACTURA;5;1;16136;3066;19202
FAC0037339;2015-06-12;CLI00638;FACTURA;13;1;176360;33508;209868
FAC0037340;2015-02-22;CLI00826;FACTURA;32;1;48408;9198;57606
FAC0037341;2015-12-28;CLI00504;FACTURA;41;1;62874;11946;74820
FAC0037342;2015-12-20;CLI00856;FACTURA;38;1;117036;22237;139273
FAC0037343;2015-09-18;CLI00457;FACTURA;50;2;25298;4807;30105
FAC0037344;2015-01-09;CLI00287;FACTURA;19;2;177086;33646;210732
FAC0037345;2015-06-17;CLI00928;FACTURA;17;1;80588;15312;95900
FAC0037346;2015-04-26;CLI00632;FACTURA;35;1;34804;6613;41417
FAC0037347;2015-02-26;CLI00052;FACTURA;26;1;101532;19291;120823
FAC0037348;2015-12-06;CLI00371;FACTURA;16;2;47230;8974;56204
FAC0037349;2015-07-19;CLI00485;FACTURA;20;2;37784;7179;44963
FAC0037350;2015-08-14;CLI00845;FACTURA;45;2;174872;33226;208098
FAC0037351;2015-04-08;CLI00061;FACTURA;35;2;41916;7964;49880
FAC0037352;2015-09-03;CLI00686;FACTURA;5;1;61700;11723;73423
FAC0037353;2015-12-28;CLI00321;FACTURA;39;2;123340;23435;146775
FAC0037354;2015-07-03;CLI00590;FACTURA;9;1;34804;6613;41417
FAC0037355;2015-05-21;CLI00540;FACTURA;48;1;37932;7207;45139
FAC0037356;2015-03-05;CLI00405;FACTURA;28;2;129006;24511;153517
FAC0037357;2015-08-21;CLI00804;FACTURA;8;1;186081;35355;221436
FAC0037358;2015-01-17;CLI00491;FACTURA;9;2;123340;23435;146775
FAC0037359;2015-07-13;CLI00406;FACTURA;30;1;85014;16153;101167
FAC0037360;2015-09-03;CLI00011;FACTURA;48;2;34362;6529;40891
FAC0037361;2015-10-20;CLI00809;FACTURA;20;2;18537;3522;22059
FAC0037362;2015-01-09;CLI00623;FACTURA;40;2;91492;17383;108875
FAC0037363;2015-12-15;CLI00343;FACTURA;5;2;136748;25982;162730
FAC0037364;2015-07-15;CLI00868;FACTURA;17;1;12358;2348;14706
FAC0037365;2015-04-29;CLI00883;FACTURA;8;2;132915;25254;158169
FAC0037366;2015-02-04;CLI00442;FACTURA;11;1;152298;28937;181235
FAC0037367;2015-03-05;CLI00539;FACTURA;11;2;45104;8570;53674
FAC0037368;2015-12-24;CLI00366;FACTURA;34;1;12358;2348;14706
FAC0037369;2015-09-06;CLI00052;FACTURA;5;1;24680;4689;29369
FAC0037370;2015-01-17;CLI00369;FACTURA;2;2;11454;2176;13630
FAC0037371;2015-01-09;CLI00287;FACTURA;19;2;68619;13038;81657
FAC0037372;2015-07-05;CLI00150;FACTURA;21;1;128280;24373;152653
FAC0037373;2015-01-02;CLI00463;FACTURA;8;2;129006;24511;153517
FAC0037374;2015-02-13;CLI00137;FACTURA;45;2;196245;37287;233532
FAC0037375;2015-06-14;CLI00738;FACTURA;23;1;85640;16272;101912
FAC0037376;2015-11-02;CLI00805;FACTURA;22;2;29003;5511;34514
FAC0037377;2015-09-09;CLI00896;FACTURA;49;1;18510;3517;22027
FAC0037378;2015-05-15;CLI00015;FACTURA;23;2;57016;10833;67849
FAC0037379;2015-05-29;CLI00979;FACTURA;45;2;136542;25943;162485
FAC0037380;2015-10-12;CLI00307;FACTURA;24;2;273496;51964;325460
FAC0037381;2015-09-29;CLI00809;FACTURA;13;2;155442;29534;184976
FAC0037382;2015-11-06;CLI00177;FACTURA;48;2;45278;8603;53881
FAC0037383;2015-05-03;CLI00626;FACTURA;22;1;217944;41409;259353
FAC0037384;2015-05-23;CLI00123;FACTURA;34;2;85014;16153;101167
FAC0037385;2015-09-29;CLI00443;FACTURA;18;2;55622;10568;66190
FAC0037386;2015-03-11;CLI00013;FACTURA;17;2;174872;33226;208098
FAC0037387;2015-10-16;CLI00358;FACTURA;37;1;208260;39569;247829
FAC0037388;2015-11-29;CLI00892;FACTURA;45;1;81372;15461;96833
FAC0037389;2015-10-04;CLI00828;FACTURA;37;1;18510;3517;22027
FAC0037390;2015-08-30;CLI00518;FACTURA;34;1;114540;21763;136303
FAC0037391;2015-11-25;CLI00640;FACTURA;9;1;49432;9392;58824
FAC0037392;2015-10-20;CLI00380;FACTURA;12;1;49360;9378;58738
FAC0037393;2015-02-19;CLI00352;FACTURA;7;1;20958;3982;24940
FAC0037394;2015-01-20;CLI00638;FACTURA;27;1;55530;10551;66081
FAC0037395;2015-08-26;CLI00888;FACTURA;12;1;27709;5265;32974
FAC0037396;2015-06-29;CLI00202;FACTURA;11;1;160350;30467;190817
FAC0037397;2015-10-30;CLI00329;FACTURA;18;2;60441;11484;71925
FAC0037398;2015-06-30;CLI00219;FACTURA;11;2;97530;18531;116061
FAC0037399;2015-02-10;CLI00568;FACTURA;48;1;28111;5341;33452
FAC0037400;2015-04-04;CLI00537;FACTURA;21;2;43002;8170;51172
FAC0037401;2015-01-07;CLI00058;FACTURA;1;1;7946;1510;9456
FAC0037402;2015-06-27;CLI00086;FACTURA;47;1;104790;19910;124700
FAC0037403;2015-12-09;CLI00847;FACTURA;37;2;18892;3589;22481
FAC0037404;2015-10-16;CLI00717;FACTURA;26;2;114032;21666;135698
FAC0037405;2015-05-01;CLI00578;FACTURA;25;1;81372;15461;96833
FAC0037406;2015-11-05;CLI00424;FACTURA;20;1;22639;4301;26940
FAC0037407;2015-05-21;CLI00280;FACTURA;49;1;172676;32808;205484
FAC0037408;2015-03-01;CLI00107;FACTURA;37;2;80680;15329;96009
FAC0037409;2015-06-28;CLI00485;FACTURA;48;2;177648;33753;211401
FAC0037410;2015-11-14;CLI00947;FACTURA;28;2;37784;7179;44963
FAC0037411;2015-03-26;CLI00721;FACTURA;37;2;123452;23456;146908
FAC0037412;2015-10-22;CLI00794;FACTURA;47;1;80680;15329;96009
FAC0037413;2015-11-24;CLI00467;FACTURA;33;2;62874;11946;74820
FAC0037414;2015-07-13;CLI00476;FACTURA;14;1;47668;9057;56725
FAC0037415;2015-09-23;CLI00503;FACTURA;8;2;109025;20715;129740
FAC0037416;2015-06-15;CLI00805;FACTURA;32;2;189497;36004;225501
FAC0037417;2015-06-24;CLI00587;FACTURA;50;2;294894;56030;350924
FAC0037418;2015-08-09;CLI00453;FACTURA;44;2;139216;26451;165667
FAC0037419;2015-01-03;CLI00557;FACTURA;10;2;203248;38617;241865
FAC0037420;2015-03-14;CLI00789;FACTURA;45;2;47676;9058;56734
FAC0037421;2015-06-11;CLI00639;FACTURA;47;2;67194;12767;79961
FAC0037422;2015-10-07;CLI00343;FACTURA;35;2;162426;30861;193287
FAC0037423;2015-10-14;CLI00923;FACTURA;44;2;159498;30305;189803
FAC0037424;2015-06-28;CLI00333;FACTURA;23;2;136215;25881;162096
FAC0037425;2015-02-07;CLI00911;FACTURA;40;2;229362;43579;272941
FAC0037426;2015-01-24;CLI00073;FACTURA;36;2;163830;31128;194958
FAC0037427;2015-09-17;CLI00420;FACTURA;30;1;335970;63834;399804
FAC0037428;2015-11-27;CLI00293;FACTURA;47;2;37794;7181;44975
FAC0037429;2015-05-29;CLI00460;FACTURA;33;1;170073;32314;202387
FAC0037430;2015-02-21;CLI00251;FACTURA;49;2;87009;16532;103541
FAC0037431;2015-06-20;CLI00540;FACTURA;10;1;44412;8438;52850
FAC0037432;2015-06-22;CLI00248;FACTURA;6;1;5638;1071;6709
FAC0037433;2015-12-06;CLI00522;FACTURA;6;1;142401;27056;169457
FAC0037434;2015-10-17;CLI00814;FACTURA;14;1;65577;12460;78037
FAC0037435;2015-04-20;CLI00580;FACTURA;23;1;171048;32499;203547
FAC0037436;2015-08-30;CLI00750;FACTURA;34;1;166254;31588;197842
FAC0037437;2015-01-16;CLI00153;FACTURA;47;2;252980;48066;301046
FAC0037438;2015-06-29;CLI00594;FACTURA;17;1;161360;30658;192018
FAC0037439;2015-08-03;CLI00855;FACTURA;1;2;226390;43014;269404
FAC0037440;2015-08-30;CLI00333;FACTURA;9;2;243639;46291;289930
FAC0037441;2015-05-30;CLI00843;FACTURA;31;2;113382;21543;134925
FAC0037442;2015-03-26;CLI00396;FACTURA;15;1;85640;16272;101912
FAC0037443;2015-07-25;CLI00266;FACTURA;42;1;54142;10287;64429
FAC0037444;2015-12-28;CLI00984;FACTURA;9;1;83832;15928;99760
FAC0037445;2015-05-01;CLI00949;FACTURA;9;2;168666;32047;200713
FAC0037446;2015-10-18;CLI00601;FACTURA;42;2;66122;12563;78685
FAC0037447;2015-09-19;CLI00335;FACTURA;11;2;114365;21729;136094
FAC0037448;2015-01-26;CLI00775;FACTURA;25;2;34804;6613;41417
FAC0037449;2015-07-07;CLI00570;FACTURA;44;1;126582;24051;150633
FAC0037450;2015-01-16;CLI00025;FACTURA;21;2;35272;6702;41974
FAC0037451;2015-12-28;CLI00416;FACTURA;15;1;21117;4012;25129
FAC0037452;2015-04-11;CLI00029;FACTURA;50;2;91632;17410;109042
FAC0037453;2015-08-29;CLI00363;FACTURA;48;2;114032;21666;135698
FAC0037454;2015-10-07;CLI00394;FACTURA;34;1;170935;32478;203413
FAC0037455;2015-09-08;CLI00505;FACTURA;22;2;100791;19150;119941
FAC0037456;2015-11-26;CLI00474;FACTURA;2;1;232024;44085;276109
FAC0037457;2015-12-24;CLI00731;FACTURA;34;2;232024;44085;276109
FAC0037458;2015-08-27;CLI00737;FACTURA;43;2;235179;44684;279863
FAC0037459;2015-12-24;CLI00859;FACTURA;6;2;56222;10682;66904
FAC0037460;2015-10-10;CLI00102;FACTURA;50;1;228064;43332;271396
FAC0037461;2015-03-28;CLI00024;FACTURA;9;1;226390;43014;269404
FAC0037462;2015-08-17;CLI00931;FACTURA;35;2;83832;15928;99760
FAC0037463;2015-01-27;CLI00012;FACTURA;42;1;73353;13937;87290
FAC0037464;2015-09-05;CLI00441;FACTURA;11;2;136740;25981;162721
FAC0037465;2015-05-27;CLI00141;FACTURA;50;2;63568;12078;75646
FAC0037466;2015-08-16;CLI00990;FACTURA;42;1;218050;41430;259480
FAC0037467;2015-03-31;CLI00450;FACTURA;43;1;249381;47382;296763
FAC0037468;2015-03-02;CLI00721;FACTURA;6;2;156048;29649;185697
FAC0037469;2015-11-19;CLI00890;FACTURA;18;1;83832;15928;99760
FAC0037470;2015-11-09;CLI00474;FACTURA;1;1;80680;15329;96009
FAC0037471;2015-11-12;CLI00928;FACTURA;28;1;83832;15928;99760
FAC0037472;2015-06-13;CLI00438;FACTURA;42;1;203751;38713;242464
FAC0037473;2015-09-30;CLI00156;FACTURA;10;1;190053;36110;226163
FAC0037474;2015-05-29;CLI00259;FACTURA;33;2;281110;53411;334521
FAC0037475;2015-04-15;CLI00373;FACTURA;13;2;34710;6595;41305
FAC0037476;2015-02-09;CLI00968;FACTURA;32;1;294894;56030;350924
FAC0037477;2015-08-12;CLI00155;FACTURA;22;2;217944;41409;259353
FAC0037478;2015-08-07;CLI00853;FACTURA;44;2;312390;59354;371744
FAC0037479;2015-08-12;CLI00042;FACTURA;37;1;34710;6595;41305
FAC0037480;2015-04-21;CLI00025;FACTURA;49;2;66122;12563;78685
FAC0037481;2015-09-15;CLI00588;FACTURA;13;1;35272;6702;41974
FAC0037482;2015-06-03;CLI00887;FACTURA;16;2;177842;33790;211632
FAC0037483;2015-08-25;CLI00098;FACTURA;7;1;160111;30421;190532
FAC0037484;2015-03-21;CLI00115;FACTURA;50;2;261027;49595;310622
FAC0037485;2015-03-04;CLI00913;FACTURA;30;2;30850;5862;36712
FAC0037486;2015-04-28;CLI00454;FACTURA;20;1;50946;9680;60626
FAC0037487;2015-08-15;CLI00476;FACTURA;25;1;126490;24033;150523
FAC0037488;2015-06-28;CLI00174;FACTURA;12;1;30438;5783;36221
FAC0037489;2015-03-19;CLI00295;FACTURA;4;2;29003;5511;34514
FAC0037490;2015-05-09;CLI00304;FACTURA;8;1;104790;19910;124700
FAC0037491;2015-10-12;CLI00379;FACTURA;38;2;21117;4012;25129
FAC0037492;2015-10-02;CLI00315;FACTURA;15;2;80175;15233;95408
FAC0037493;2015-01-06;CLI00397;FACTURA;26;2;174018;33063;207081
FAC0037494;2015-10-19;CLI00970;FACTURA;45;1;177842;33790;211632
FAC0037495;2015-08-05;CLI00570;FACTURA;10;1;22552;4285;26837
FAC0037496;2015-10-10;CLI00429;FACTURA;17;2;18537;3522;22059
FAC0037497;2015-10-13;CLI00442;FACTURA;13;1;104790;19910;124700
FAC0037498;2015-01-31;CLI00632;FACTURA;41;1;55530;10551;66081
FAC0037499;2015-12-11;CLI00710;FACTURA;45;1;313236;59515;372751
FAC0037500;2015-01-06;CLI00534;FACTURA;16;1;203430;38652;242082
FAC0037501;2015-07-29;CLI00932;FACTURA;49;1;113195;21507;134702
FAC0037502;2015-07-04;CLI00573;FACTURA;34;2;68374;12991;81365
FAC0037503;2015-11-14;CLI00841;FACTURA;6;2;21410;4068;25478
FAC0037504;2015-03-18;CLI00792;FACTURA;43;1;33828;6427;40255
FAC0037505;2015-08-14;CLI00723;FACTURA;6;2;49360;9378;58738
FAC0037506;2015-01-31;CLI00851;FACTURA;15;2;40294;7656;47950
FAC0037507;2015-03-23;CLI00269;FACTURA;5;2;136542;25943;162485
FAC0037508;2015-03-22;CLI00064;FACTURA;17;1;142540;27083;169623
FAC0037509;2015-03-08;CLI00847;FACTURA;43;2;15892;3019;18911
FAC0037510;2015-02-09;CLI00939;FACTURA;16;2;100791;19150;119941
FAC0037511;2015-03-03;CLI00093;FACTURA;39;2;14334;2723;17057
FAC0037512;2015-07-22;CLI00263;FACTURA;48;2;148008;28122;176130
FAC0037513;2015-12-15;CLI00395;FACTURA;16;2;101192;19226;120418
FAC0037514;2015-04-04;CLI00965;FACTURA;44;2;9446;1795;11241
FAC0037515;2015-03-22;CLI00149;FACTURA;15;2;57336;10894;68230
FAC0037516;2015-11-25;CLI00529;FACTURA;3;2;100735;19140;119875
FAC0037517;2015-08-15;CLI00809;FACTURA;23;2;67688;12861;80549
FAC0037518;2015-06-14;CLI00026;FACTURA;31;1;34710;6595;41305
FAC0037519;2015-06-11;CLI00512;FACTURA;36;1;127030;24136;151166
FAC0037520;2015-10-08;CLI00915;FACTURA;46;2;45746;8692;54438
FAC0037521;2015-07-23;CLI00812;FACTURA;16;1;18510;3517;22027
FAC0037522;2015-12-15;CLI00285;FACTURA;15;2;196904;37412;234316
FAC0037523;2015-10-28;CLI00919;FACTURA;20;2;160111;30421;190532
FAC0037524;2015-10-13;CLI00226;FACTURA;23;1;40804;7753;48557
FAC0037525;2015-03-09;CLI00528;FACTURA;50;1;229257;43559;272816
FAC0037526;2015-09-22;CLI00283;FACTURA;28;2;40294;7656;47950
FAC0037527;2015-03-31;CLI00078;FACTURA;42;1;25406;4827;30233
FAC0037528;2015-01-09;CLI00691;FACTURA;14;2;175554;33355;208909
FAC0037529;2015-07-17;CLI00601;FACTURA;10;2;50946;9680;60626
FAC0037530;2015-02-06;CLI00977;FACTURA;11;2;47668;9057;56725
FAC0037531;2015-05-01;CLI00997;FACTURA;38;2;94311;17919;112230
FAC0037532;2015-10-06;CLI00940;FACTURA;13;1;218050;41430;259480
FAC0037533;2015-06-18;CLI00821;FACTURA;21;2;74004;14061;88065
FAC0037534;2015-07-29;CLI00806;FACTURA;7;1;44412;8438;52850
FAC0037535;2015-08-29;CLI00331;FACTURA;30;2;327660;62255;389915
FAC0037536;2015-12-22;CLI00334;FACTURA;42;1;42820;8136;50956
FAC0037537;2015-11-11;CLI00599;FACTURA;40;2;205857;39113;244970
FAC0037538;2015-07-22;CLI00839;FACTURA;48;2;5638;1071;6709
FAC0037539;2015-02-17;CLI00897;FACTURA;43;2;126702;24073;150775
FAC0037540;2015-09-16;CLI00115;FACTURA;39;2;152838;29039;181877
FAC0037541;2015-05-15;CLI00770;FACTURA;38;1;208260;39569;247829
FAC0037542;2015-04-19;CLI00535;FACTURA;33;2;16896;3210;20106
FAC0037543;2015-05-11;CLI00759;FACTURA;25;2;101624;19309;120933
FAC0037544;2015-11-22;CLI00504;FACTURA;14;1;61700;11723;73423
FAC0037545;2015-12-09;CLI00494;FACTURA;28;1;208260;39569;247829
FAC0037546;2015-08-04;CLI00026;FACTURA;42;1;65415;12429;77844
FAC0037547;2015-10-21;CLI00994;FACTURA;13;1;25406;4827;30233
FAC0037548;2015-10-13;CLI00473;FACTURA;30;2;203021;38574;241595
FAC0037549;2015-06-29;CLI00052;FACTURA;41;1;41916;7964;49880
FAC0037550;2015-02-27;CLI00738;FACTURA;28;1;114540;21763;136303
FAC0037551;2015-09-04;CLI00805;FACTURA;27;2;277090;52647;329737
FAC0037552;2015-01-06;CLI00246;FACTURA;11;1;138545;26324;164869
FAC0037553;2015-10-24;CLI00585;FACTURA;20;2;228064;43332;271396
FAC0037554;2015-05-25;CLI00335;FACTURA;20;2;114032;21666;135698
FAC0037555;2015-05-21;CLI00471;FACTURA;28;2;24613;4676;29289
FAC0037556;2015-08-05;CLI00715;FACTURA;16;2;196596;37353;233949
FAC0037557;2015-08-23;CLI00182;FACTURA;12;1;65415;12429;77844
FAC0037558;2015-11-17;CLI00527;FACTURA;7;2;91809;17444;109253
FAC0037559;2015-07-13;CLI00738;FACTURA;48;1;203430;38652;242082
FAC0037560;2015-06-22;CLI00390;FACTURA;46;1;47668;9057;56725
FAC0037561;2015-02-19;CLI00648;FACTURA;48;1;113382;21543;134925
FAC0037562;2015-03-10;CLI00656;FACTURA;3;1;183087;34787;217874
FAC0037563;2015-08-21;CLI00618;FACTURA;31;1;102561;19487;122048
FAC0037564;2015-08-06;CLI00049;FACTURA;13;2;76032;14446;90478
FAC0037565;2015-03-27;CLI00615;FACTURA;3;2;123065;23382;146447
FAC0037566;2015-03-03;CLI00274;FACTURA;50;1;245187;46586;291773
FAC0037567;2015-08-02;CLI00097;FACTURA;39;2;47230;8974;56204
FAC0037568;2015-09-11;CLI00201;FACTURA;10;2;169220;32152;201372
FAC0037569;2015-04-07;CLI00106;FACTURA;39;1;87436;16613;104049
FAC0037570;2015-10-06;CLI00228;FACTURA;21;1;54486;10352;64838
FAC0037571;2015-08-01;CLI00516;FACTURA;25;1;126490;24033;150523
FAC0037572;2015-10-22;CLI00793;FACTURA;1;2;228654;43444;272098
FAC0037573;2015-05-27;CLI00053;FACTURA;15;2;201582;38301;239883
FAC0037574;2015-11-03;CLI00386;FACTURA;18;1;265830;50508;316338
FAC0037575;2015-11-02;CLI00941;FACTURA;36;2;160350;30467;190817
FAC0037576;2015-05-28;CLI00836;FACTURA;4;1;211170;40122;251292
FAC0037577;2015-03-28;CLI00767;FACTURA;20;2;57016;10833;67849
FAC0037578;2015-10-06;CLI00392;FACTURA;24;1;174018;33063;207081
FAC0037579;2015-11-13;CLI00725;FACTURA;50;2;41022;7794;48816
FAC0037580;2015-01-16;CLI00960;FACTURA;40;1;81372;15461;96833
FAC0037581;2015-04-29;CLI00993;FACTURA;49;2;103086;19586;122672
FAC0037582;2015-06-17;CLI00816;FACTURA;12;1;123340;23435;146775
FAC0037583;2015-05-09;CLI00090;FACTURA;10;1;6170;1172;7342
FAC0037584;2015-03-07;CLI00144;FACTURA;1;1;24668;4687;29355
FAC0037585;2015-08-18;CLI00199;FACTURA;25;2;61790;11740;73530
FAC0037586;2015-02-23;CLI00974;FACTURA;24;1;208824;39677;248501
FAC0037587;2015-01-06;CLI00003;FACTURA;10;2;28190;5356;33546
FAC0037588;2015-03-20;CLI00743;FACTURA;11;2;83832;15928;99760
FAC0037589;2015-05-05;CLI00665;FACTURA;9;2;56676;10768;67444
FAC0037590;2015-08-17;CLI00830;FACTURA;39;1;109025;20715;129740
FAC0037591;2015-12-17;CLI00366;FACTURA;4;1;61206;11629;72835
FAC0037592;2015-05-19;CLI00988;FACTURA;12;1;47230;8974;56204
FAC0037593;2015-08-07;CLI00641;FACTURA;2;2;34362;6529;40891
FAC0037594;2015-02-21;CLI00616;FACTURA;31;1;71514;13588;85102
FAC0037595;2015-09-12;CLI00808;FACTURA;17;1;190701;36233;226934
FAC0037596;2015-11-01;CLI00769;FACTURA;49;2;141088;26807;167895
FAC0037597;2015-01-31;CLI00601;FACTURA;23;2;203021;38574;241595
FAC0037598;2015-01-02;CLI00857;FACTURA;29;2;123065;23382;146447
FAC0037599;2015-04-09;CLI00492;FACTURA;39;1;95718;18186;113904
FAC0037600;2015-04-17;CLI00624;FACTURA;19;1;137238;26075;163313
FAC0037601;2015-09-17;CLI00987;FACTURA;8;2;109025;20715;129740
FAC0037602;2015-08-25;CLI00990;FACTURA;40;1;151176;28723;179899
FAC0037603;2015-08-20;CLI00802;FACTURA;37;1;159498;30305;189803
FAC0037604;2015-10-28;CLI00497;FACTURA;23;2;224888;42729;267617
FAC0037605;2015-03-09;CLI00649;FACTURA;23;2;126582;24051;150633
FAC0037606;2015-09-27;CLI00966;FACTURA;21;1;169220;32152;201372
FAC0037607;2015-01-28;CLI00728;FACTURA;38;1;85347;16216;101563
FAC0037608;2015-01-28;CLI00201;FACTURA;31;2;144315;27420;171735
FAC0037609;2015-03-22;CLI00942;FACTURA;16;1;126702;24073;150775
FAC0037610;2015-09-02;CLI00387;FACTURA;44;2;158724;30158;188882
FAC0037611;2015-10-05;CLI00713;FACTURA;28;2;161360;30658;192018
FAC0037612;2015-03-25;CLI00710;FACTURA;9;1;98452;18706;117158
FAC0037613;2015-02-01;CLI00961;FACTURA;35;2;170935;32478;203413
FAC0037614;2015-03-02;CLI00904;FACTURA;47;1;24680;4689;29369
FAC0037615;2015-09-05;CLI00093;FACTURA;22;2;12340;2345;14685
FAC0037616;2015-12-11;CLI00193;FACTURA;32;2;20958;3982;24940
FAC0037617;2015-05-11;CLI00650;FACTURA;37;1;98298;18677;116975
FAC0037618;2015-02-21;CLI00217;FACTURA;31;2;104130;19785;123915
FAC0037619;2015-06-06;CLI00333;FACTURA;13;2;64140;12187;76327
FAC0037620;2015-11-02;CLI00278;FACTURA;49;1;54142;10287;64429
FAC0037621;2015-01-08;CLI00460;FACTURA;45;1;112952;21461;134413
FAC0037622;2015-05-10;CLI00843;FACTURA;20;2;54142;10287;64429
FAC0037623;2015-11-14;CLI00146;FACTURA;14;1;307683;58460;366143
FAC0037624;2015-01-23;CLI00948;FACTURA;1;1;126490;24033;150523
FAC0037625;2015-03-08;CLI00896;FACTURA;23;1;224888;42729;267617
FAC0037626;2015-06-01;CLI00782;FACTURA;40;1;52395;9955;62350
FAC0037627;2015-11-02;CLI00142;FACTURA;5;1;76218;14481;90699
FAC0037628;2015-03-08;CLI00852;FACTURA;42;1;203784;38719;242503
FAC0037629;2015-04-13;CLI00462;FACTURA;8;1;75588;14362;89950
FAC0037630;2015-04-09;CLI00162;FACTURA;25;1;65577;12460;78037
FAC0037631;2015-10-07;CLI00546;FACTURA;6;1;42234;8024;50258
FAC0037632;2015-07-14;CLI00804;FACTURA;44;1;55530;10551;66081
FAC0037633;2015-03-27;CLI00995;FACTURA;49;2;100791;19150;119941
FAC0037634;2015-11-03;CLI00314;FACTURA;42;1;12358;2348;14706
FAC0037635;2015-03-14;CLI00642;FACTURA;2;1;20402;3876;24278
FAC0037636;2015-08-30;CLI00274;FACTURA;14;1;101624;19309;120933
FAC0037637;2015-08-21;CLI00552;FACTURA;27;1;195060;37061;232121
FAC0037638;2015-10-24;CLI00423;FACTURA;50;2;91314;17350;108664
FAC0037639;2015-01-04;CLI00247;FACTURA;44;2;21410;4068;25478
FAC0037640;2015-07-24;CLI00901;FACTURA;7;2;152298;28937;181235
FAC0037641;2015-04-27;CLI00811;FACTURA;25;2;31784;6039;37823
FAC0037642;2015-07-05;CLI00630;FACTURA;9;1;74004;14061;88065
FAC0037643;2015-01-21;CLI00218;FACTURA;10;1;83419;15850;99269
FAC0037644;2015-12-24;CLI00881;FACTURA;38;2;216568;41148;257716
FAC0037645;2015-12-23;CLI00842;FACTURA;38;1;95718;18186;113904
FAC0037646;2015-05-01;CLI00066;FACTURA;37;1;84468;16049;100517
FAC0037647;2015-11-28;CLI00910;FACTURA;12;1;12340;2345;14685
FAC0037648;2015-08-23;CLI00577;FACTURA;36;2;137238;26075;163313
FAC0037649;2015-06-05;CLI00118;FACTURA;40;1;196904;37412;234316
FAC0037650;2015-12-10;CLI00377;FACTURA;13;2;156048;29649;185697
FAC0037651;2015-11-07;CLI00652;FACTURA;22;1;24716;4696;29412
FAC0037652;2015-09-02;CLI00826;FACTURA;16;1;83832;15928;99760
FAC0037653;2015-04-15;CLI00534;FACTURA;1;1;201470;38279;239749
FAC0037654;2015-01-23;CLI00905;FACTURA;2;2;107253;20378;127631
FAC0037655;2015-02-12;CLI00767;FACTURA;2;2;16035;3047;19082
FAC0037656;2015-10-27;CLI00187;FACTURA;4;2;68619;13038;81657
FAC0037657;2015-07-16;CLI00099;FACTURA;11;2;84388;16034;100422
FAC0037658;2015-11-27;CLI00332;FACTURA;1;1;98672;18748;117420
FAC0037659;2015-03-17;CLI00470;FACTURA;19;1;70544;13403;83947
FAC0037660;2015-04-20;CLI00549;FACTURA;34;2;126490;24033;150523
FAC0037661;2015-08-11;CLI00501;FACTURA;18;2;242970;46164;289134
FAC0037662;2015-11-16;CLI00052;FACTURA;24;1;278432;52902;331334
FAC0037663;2015-07-17;CLI00423;FACTURA;17;2;78024;14825;92849
FAC0037664;2015-08-16;CLI00589;FACTURA;25;2;163830;31128;194958
FAC0037665;2015-03-22;CLI00109;FACTURA;11;2;56691;10771;67462
FAC0037666;2015-03-09;CLI00595;FACTURA;10;2;30603;5815;36418
FAC0037667;2015-08-02;CLI00031;FACTURA;33;2;139216;26451;165667
FAC0037668;2015-02-14;CLI00735;FACTURA;1;2;88180;16754;104934
FAC0037669;2015-11-12;CLI00784;FACTURA;22;1;42194;8017;50211
FAC0037670;2015-09-19;CLI00120;FACTURA;19;1;108972;20705;129677
FAC0037671;2015-07-15;CLI00645;FACTURA;37;2;76218;14481;90699
FAC0037672;2015-10-30;CLI00916;FACTURA;35;1;84610;16076;100686
FAC0037673;2015-08-25;CLI00785;FACTURA;30;2;261027;49595;310622
FAC0037674;2015-01-15;CLI00799;FACTURA;34;2;172676;32808;205484
FAC0037675;2015-12-10;CLI00440;FACTURA;10;1;75894;14420;90314
FAC0037676;2015-03-18;CLI00104;FACTURA;15;1;126702;24073;150775
FAC0037677;2015-04-06;CLI00861;FACTURA;1;2;116012;22042;138054
FAC0037678;2015-03-13;CLI00064;FACTURA;24;1;51005;9691;60696
FAC0037679;2015-04-15;CLI00637;FACTURA;33;2;113195;21507;134702
FAC0037680;2015-10-09;CLI00687;FACTURA;41;2;76032;14446;90478
FAC0037681;2015-12-24;CLI00515;FACTURA;46;2;71407;13567;84974
FAC0037682;2015-12-28;CLI00590;FACTURA;3;1;85347;16216;101563
FAC0037683;2015-08-02;CLI00805;FACTURA;31;2;156048;29649;185697
FAC0037684;2015-05-18;CLI00271;FACTURA;43;2;71502;13585;85087
FAC0037685;2015-05-19;CLI00976;FACTURA;13;1;25406;4827;30233
FAC0037686;2015-03-14;CLI00428;FACTURA;46;1;181323;34451;215774
FAC0037687;2015-12-02;CLI00364;FACTURA;16;1;25473;4840;30313
FAC0037688;2015-05-06;CLI00949;FACTURA;9;2;27071;5143;32214
FAC0037689;2015-09-22;CLI00247;FACTURA;46;2;75864;14414;90278
FAC0037690;2015-10-31;CLI00321;FACTURA;31;2;24668;4687;29355
FAC0037691;2015-04-25;CLI00275;FACTURA;16;2;94485;17952;112437
FAC0037692;2015-03-28;CLI00746;FACTURA;4;1;101715;19326;121041
FAC0037693;2015-08-17;CLI00612;FACTURA;34;1;136748;25982;162730
FAC0037694;2015-09-27;CLI00052;FACTURA;9;1;39730;7549;47279
FAC0037695;2015-07-17;CLI00768;FACTURA;39;1;81729;15529;97258
FAC0037696;2015-06-17;CLI00680;FACTURA;35;1;55418;10529;65947
FAC0037697;2015-10-21;CLI00176;FACTURA;39;1;104130;19785;123915
FAC0037698;2015-05-04;CLI00949;FACTURA;41;2;27348;5196;32544
FAC0037699;2015-11-15;CLI00007;FACTURA;30;2;189873;36076;225949
FAC0037700;2015-02-12;CLI00687;FACTURA;38;2;222060;42191;264251
FAC0037701;2015-02-25;CLI00260;FACTURA;37;1;27709;5265;32974
FAC0037702;2015-09-11;CLI00766;FACTURA;5;1;55530;10551;66081
FAC0037703;2015-05-13;CLI00742;FACTURA;20;1;114365;21729;136094
FAC0037704;2015-01-12;CLI00882;FACTURA;24;1;109295;20766;130061
FAC0037705;2015-02-07;CLI00458;FACTURA;48;1;123340;23435;146775
FAC0037706;2015-01-05;CLI00813;FACTURA;24;2;281110;53411;334521
FAC0037707;2015-04-24;CLI00113;FACTURA;22;2;73839;14029;87868
FAC0037708;2015-05-07;CLI00907;FACTURA;8;2;122058;23191;145249
FAC0037709;2015-04-15;CLI00386;FACTURA;43;1;152436;28963;181399
FAC0037710;2015-05-29;CLI00826;FACTURA;34;1;138840;26380;165220
FAC0037711;2015-12-10;CLI00886;FACTURA;9;1;285080;54165;339245
FAC0037712;2015-03-22;CLI00979;FACTURA;38;2;173550;32975;206525
FAC0037713;2015-05-31;CLI00437;FACTURA;11;2;246680;46869;293549
FAC0037714;2015-08-12;CLI00461;FACTURA;30;2;134388;25534;159922
FAC0037715;2015-01-02;CLI00877;FACTURA;48;2;21859;4153;26012
FAC0037716;2015-05-21;CLI00420;FACTURA;30;1;108972;20705;129677
FAC0037717;2015-02-04;CLI00463;FACTURA;41;2;39012;7412;46424
FAC0037718;2015-04-22;CLI00823;FACTURA;6;2;232024;44085;276109
FAC0037719;2015-03-13;CLI00594;FACTURA;35;1;131154;24919;156073
FAC0037720;2015-01-06;CLI00099;FACTURA;44;2;68374;12991;81365
FAC0037721;2015-10-01;CLI00924;FACTURA;42;1;159498;30305;189803
FAC0037722;2015-12-19;CLI00607;FACTURA;48;2;221672;42118;263790
FAC0037723;2015-06-25;CLI00342;FACTURA;34;1;341870;64955;406825
FAC0037724;2015-01-02;CLI00589;FACTURA;11;2;45278;8603;53881
FAC0037725;2015-10-28;CLI00239;FACTURA;3;2;177842;33790;211632
FAC0037726;2015-10-01;CLI00459;FACTURA;26;2;30603;5815;36418
FAC0037727;2015-09-08;CLI00346;FACTURA;41;1;71407;13567;84974
FAC0037728;2015-05-30;CLI00851;FACTURA;41;2;17636;3351;20987
FAC0037729;2015-09-28;CLI00704;FACTURA;6;1;104130;19785;123915
FAC0037730;2015-09-11;CLI00612;FACTURA;25;1;88824;16877;105701
FAC0037731;2015-09-02;CLI00049;FACTURA;15;2;120882;22968;143850
FAC0037732;2015-04-01;CLI00489;FACTURA;22;2;224888;42729;267617
FAC0037733;2015-03-06;CLI00703;FACTURA;22;2;68724;13058;81782
FAC0037734;2015-04-23;CLI00135;FACTURA;29;2;68374;12991;81365
FAC0037735;2015-08-13;CLI00636;FACTURA;13;1;8448;1605;10053
FAC0037736;2015-01-17;CLI00307;FACTURA;21;2;32766;6226;38992
FAC0037737;2015-06-03;CLI00636;FACTURA;20;1;94485;17952;112437
FAC0037738;2015-07-02;CLI00785;FACTURA;45;2;9446;1795;11241
FAC0037739;2015-10-01;CLI00196;FACTURA;23;1;168666;32047;200713
FAC0037740;2015-12-22;CLI00763;FACTURA;21;2;201582;38301;239883
FAC0037741;2015-06-28;CLI00246;FACTURA;3;1;78024;14825;92849
FAC0037742;2015-05-06;CLI00462;FACTURA;5;1;199854;37972;237826
FAC0037743;2015-12-13;CLI00826;FACTURA;5;1;239247;45457;284704
FAC0037744;2015-01-22;CLI00451;FACTURA;14;2;135376;25721;161097
FAC0037745;2015-06-03;CLI00697;FACTURA;35;2;226390;43014;269404
FAC0037746;2015-05-08;CLI00668;FACTURA;23;1;47676;9058;56734
FAC0037747;2015-09-20;CLI00983;FACTURA;26;2;81608;15506;97114
FAC0037748;2015-03-24;CLI00836;FACTURA;50;1;65532;12451;77983
FAC0037749;2015-11-07;CLI00461;FACTURA;48;2;43718;8306;52024
FAC0037750;2015-01-21;CLI00186;FACTURA;14;1;168936;32098;201034
FAC0037751;2015-01-08;CLI00067;FACTURA;29;2;67584;12841;80425
FAC0037752;2015-04-30;CLI00029;FACTURA;38;2;335970;63834;399804
FAC0037753;2015-07-22;CLI00170;FACTURA;44;1;50730;9639;60369
FAC0037754;2015-11-19;CLI00389;FACTURA;14;2;262128;49804;311932
FAC0037755;2015-12-25;CLI00142;FACTURA;47;1;54486;10352;64838
FAC0037756;2015-09-21;CLI00899;FACTURA;16;2;60876;11566;72442
FAC0037757;2015-03-02;CLI00264;FACTURA;49;1;48105;9140;57245
FAC0037758;2015-12-21;CLI00006;FACTURA;30;1;168776;32067;200843
FAC0037759;2015-11-04;CLI00804;FACTURA;36;1;170073;32314;202387
FAC0037760;2015-01-31;CLI00485;FACTURA;25;2;243628;46289;289917
FAC0037761;2015-11-04;CLI00527;FACTURA;45;2;40584;7711;48295
FAC0037762;2015-09-24;CLI00920;FACTURA;1;1;18966;3604;22570
FAC0037763;2015-10-04;CLI00538;FACTURA;14;1;169220;32152;201372
FAC0037764;2015-12-28;CLI00020;FACTURA;8;1;123452;23456;146908
FAC0037765;2015-08-17;CLI00386;FACTURA;35;1;218050;41430;259480
FAC0037766;2015-06-25;CLI00486;FACTURA;1;1;74004;14061;88065
FAC0037767;2015-04-25;CLI00240;FACTURA;37;1;33844;6430;40274
FAC0037768;2015-07-31;CLI00685;FACTURA;4;2;81213;15430;96643
FAC0037769;2015-08-23;CLI00250;FACTURA;21;1;84333;16023;100356
FAC0037770;2015-12-28;CLI00018;FACTURA;32;1;73839;14029;87868
FAC0037771;2015-05-24;CLI00356;FACTURA;40;1;85524;16250;101774
FAC0037772;2015-11-08;CLI00659;FACTURA;26;2;105585;20061;125646
FAC0037773;2015-03-12;CLI00090;FACTURA;49;1;281110;53411;334521
FAC0037774;2015-08-14;CLI00971;FACTURA;8;2;212664;40406;253070
FAC0037775;2015-11-01;CLI00510;FACTURA;3;1;39730;7549;47279
FAC0037776;2015-05-07;CLI00276;FACTURA;41;1;94311;17919;112230
FAC0037777;2015-06-25;CLI00359;FACTURA;24;2;30895;5870;36765
FAC0037778;2015-04-03;CLI00479;FACTURA;3;2;47676;9058;56734
FAC0037779;2015-12-16;CLI00775;FACTURA;32;2;118454;22506;140960
FAC0037780;2015-10-03;CLI00122;FACTURA;44;1;243639;46291;289930
FAC0037781;2015-11-03;CLI00830;FACTURA;44;1;229257;43559;272816
FAC0037782;2015-02-19;CLI00389;FACTURA;9;2;265830;50508;316338
FAC0037783;2015-04-06;CLI00348;FACTURA;45;1;307683;58460;366143
FAC0037784;2015-07-03;CLI00852;FACTURA;32;1;158473;30110;188583
FAC0037785;2015-11-27;CLI00140;FACTURA;16;1;32272;6132;38404
FAC0037786;2015-02-03;CLI00947;FACTURA;26;2;104130;19785;123915
FAC0037787;2015-06-20;CLI00645;FACTURA;36;2;94460;17947;112407
FAC0037788;2015-06-25;CLI00384;FACTURA;17;1;76032;14446;90478
FAC0037789;2015-05-24;CLI00071;FACTURA;13;2;27071;5143;32214
FAC0037790;2015-02-09;CLI00246;FACTURA;33;1;136215;25881;162096
FAC0037791;2015-05-08;CLI00052;FACTURA;22;1;79749;15152;94901
FAC0037792;2015-06-21;CLI00055;FACTURA;21;2;111030;21096;132126
FAC0037793;2015-10-01;CLI00844;FACTURA;37;1;66618;12657;79275
FAC0037794;2015-05-27;CLI00800;FACTURA;26;1;21097;4008;25105
FAC0037795;2015-06-05;CLI00019;FACTURA;25;2;94460;17947;112407
FAC0037796;2015-09-20;CLI00341;FACTURA;43;2;229257;43559;272816
FAC0037797;2015-06-07;CLI00938;FACTURA;19;1;116012;22042;138054
FAC0037798;2015-09-20;CLI00724;FACTURA;10;1;12340;2345;14685
FAC0037799;2015-07-18;CLI00038;FACTURA;28;1;43190;8206;51396
FAC0037800;2015-08-08;CLI00815;FACTURA;48;2;218590;41532;260122
FAC0037801;2015-06-16;CLI00736;FACTURA;22;1;196731;37379;234110
FAC0037802;2015-07-09;CLI00907;FACTURA;37;2;189873;36076;225949
FAC0037803;2015-02-19;CLI00601;FACTURA;13;2;59136;11236;70372
FAC0037804;2015-06-18;CLI00806;FACTURA;42;1;196245;37287;233532
FAC0037805;2015-04-09;CLI00561;FACTURA;21;2;37794;7181;44975
FAC0037806;2015-03-21;CLI00360;FACTURA;32;1;136740;25981;162721
FAC0037807;2015-02-08;CLI00647;FACTURA;45;2;68619;13038;81657
FAC0037808;2015-07-17;CLI00807;FACTURA;18;2;152635;29001;181636
FAC0037809;2015-09-21;CLI00328;FACTURA;48;1;199854;37972;237826
FAC0037810;2015-02-08;CLI00896;FACTURA;49;1;65532;12451;77983
FAC0037811;2015-06-07;CLI00011;FACTURA;29;2;76218;14481;90699
FAC0037812;2015-07-11;CLI00553;FACTURA;9;2;94460;17947;112407
FAC0037813;2015-11-11;CLI00076;FACTURA;45;1;54142;10287;64429
FAC0037814;2015-03-02;CLI00451;FACTURA;13;2;68374;12991;81365
FAC0037815;2015-05-23;CLI00586;FACTURA;19;1;94311;17919;112230
FAC0037816;2015-02-25;CLI00574;FACTURA;30;1;97530;18531;116061
FAC0037817;2015-03-27;CLI00765;FACTURA;50;2;162744;30921;193665
FAC0037818;2015-09-03;CLI00401;FACTURA;50;2;29003;5511;34514
FAC0037819;2015-07-20;CLI00191;FACTURA;4;2;85524;16250;101774
FAC0037820;2015-03-09;CLI00662;FACTURA;18;1;132279;25133;157412
FAC0037821;2015-07-04;CLI00172;FACTURA;28;1;57336;10894;68230
FAC0037822;2015-04-25;CLI00495;FACTURA;2;2;51005;9691;60696
FAC0037823;2015-06-13;CLI00052;FACTURA;37;1;112444;21364;133808
FAC0037824;2015-10-06;CLI00715;FACTURA;46;2;22873;4346;27219
FAC0037825;2015-02-01;CLI00488;FACTURA;34;1;214100;40679;254779
FAC0037826;2015-10-04;CLI00274;FACTURA;18;1;45816;8705;54521
FAC0037827;2015-07-01;CLI00761;FACTURA;45;2;103086;19586;122672
FAC0037828;2015-06-11;CLI00394;FACTURA;12;1;171048;32499;203547
FAC0037829;2015-06-26;CLI00974;FACTURA;23;1;14334;2723;17057
FAC0037830;2015-12-25;CLI00737;FACTURA;43;2;347100;65949;413049
FAC0037831;2015-04-19;CLI00052;FACTURA;41;1;156048;29649;185697
FAC0037832;2015-05-29;CLI00959;FACTURA;44;2;161176;30623;191799
FAC0037833;2015-03-05;CLI00841;FACTURA;4;2;162744;30921;193665
FAC0037834;2015-01-19;CLI00646;FACTURA;32;1;104130;19785;123915
FAC0037835;2015-06-13;CLI00468;FACTURA;6;1;49432;9392;58824
FAC0037836;2015-03-30;CLI00990;FACTURA;29;1;182984;34767;217751
FAC0037837;2015-08-23;CLI00807;FACTURA;48;2;50812;9654;60466
FAC0037838;2015-08-30;CLI00341;FACTURA;16;2;268776;51067;319843
FAC0037839;2015-10-10;CLI00766;FACTURA;16;1;55530;10551;66081
FAC0037840;2015-08-28;CLI00697;FACTURA;38;2;290030;55106;345136
FAC0037841;2015-10-25;CLI00156;FACTURA;31;1;73353;13937;87290
FAC0037842;2015-07-29;CLI00469;FACTURA;48;2;143340;27235;170575
FAC0037843;2015-07-21;CLI00285;FACTURA;44;2;94311;17919;112230
FAC0037844;2015-02-28;CLI00219;FACTURA;46;2;136215;25881;162096
FAC0037845;2015-09-10;CLI00135;FACTURA;9;2;63351;12037;75388
FAC0037846;2015-08-06;CLI00081;FACTURA;36;2;43002;8170;51172
FAC0037847;2015-03-10;CLI00811;FACTURA;42;2;58518;11118;69636
FAC0037848;2015-11-22;CLI00811;FACTURA;27;2;168936;32098;201034
FAC0037849;2015-08-01;CLI00433;FACTURA;26;2;254060;48271;302331
FAC0037850;2015-11-05;CLI00968;FACTURA;27;1;91492;17383;108875
FAC0037851;2015-07-25;CLI00477;FACTURA;39;2;45746;8692;54438
FAC0037852;2015-11-16;CLI00976;FACTURA;44;1;109025;20715;129740
FAC0037853;2015-07-07;CLI00935;FACTURA;35;2;27243;5176;32419
FAC0037854;2015-12-02;CLI00196;FACTURA;21;1;211170;40122;251292
FAC0037855;2015-03-24;CLI00312;FACTURA;2;1;107253;20378;127631
FAC0037856;2015-04-12;CLI00353;FACTURA;30;2;135834;25808;161642
FAC0037857;2015-10-20;CLI00590;FACTURA;15;1;112245;21327;133572
FAC0037858;2015-10-08;CLI00244;FACTURA;2;1;168666;32047;200713
FAC0037859;2015-03-26;CLI00951;FACTURA;18;2;222060;42191;264251
FAC0037860;2015-02-26;CLI00052;FACTURA;33;1;101624;19309;120933
FAC0037861;2015-10-03;CLI00398;FACTURA;38;1;172676;32808;205484
FAC0037862;2015-06-29;CLI00135;FACTURA;12;2;56691;10771;67462
FAC0037863;2015-01-10;CLI00269;FACTURA;37;2;42820;8136;50956
FAC0037864;2015-08-07;CLI00137;FACTURA;46;2;40804;7753;48557
FAC0037865;2015-01-06;CLI00766;FACTURA;33;1;113195;21507;134702
FAC0037866;2015-07-26;CLI00994;FACTURA;18;1;58518;11118;69636
FAC0037867;2015-12-25;CLI00954;FACTURA;11;1;245187;46586;291773
FAC0037868;2015-02-10;CLI00395;FACTURA;25;2;203784;38719;242503
FAC0037869;2015-07-29;CLI00002;FACTURA;41;1;39466;7499;46965
FAC0037870;2015-05-12;CLI00194;FACTURA;13;1;335970;63834;399804
FAC0037871;2015-06-03;CLI00827;FACTURA;39;2;307683;58460;366143
FAC0037872;2015-01-16;CLI00763;FACTURA;8;2;142401;27056;169457
FAC0037873;2015-07-16;CLI00529;FACTURA;21;2;19506;3706;23212
FAC0037874;2015-02-19;CLI00868;FACTURA;42;1;145224;27593;172817
FAC0037875;2015-03-10;CLI00233;FACTURA;35;2;232024;44085;276109
FAC0037876;2015-12-23;CLI00505;FACTURA;45;2;94830;18018;112848
FAC0037877;2015-02-09;CLI00081;FACTURA;38;2;229257;43559;272816
FAC0037878;2015-05-01;CLI00688;FACTURA;28;1;82044;15588;97632
FAC0037879;2015-04-22;CLI00837;FACTURA;30;2;128280;24373;152653
FAC0037880;2015-09-07;CLI00656;FACTURA;38;1;123340;23435;146775
FAC0037881;2015-05-07;CLI00947;FACTURA;5;2;91492;17383;108875
FAC0037882;2015-02-07;CLI00769;FACTURA;48;2;32766;6226;38992
FAC0037883;2015-05-12;CLI00099;FACTURA;28;2;24668;4687;29355
FAC0037884;2015-02-26;CLI00461;FACTURA;19;2;145224;27593;172817
FAC0037885;2015-02-17;CLI00574;FACTURA;36;1;142540;27083;169623
FAC0037886;2015-10-07;CLI00841;FACTURA;44;2;123340;23435;146775
FAC0037887;2015-08-24;CLI00404;FACTURA;46;1;163458;31057;194515
FAC0037888;2015-07-25;CLI00561;FACTURA;3;2;101624;19309;120933
FAC0037889;2015-07-23;CLI00145;FACTURA;18;2;195060;37061;232121
FAC0037890;2015-06-30;CLI00921;FACTURA;14;2;117036;22237;139273
FAC0037891;2015-04-15;CLI00650;FACTURA;25;1;79749;15152;94901
FAC0037892;2015-01-02;CLI00063;FACTURA;46;2;290030;55106;345136
FAC0037893;2015-04-09;CLI00476;FACTURA;40;1;181112;34411;215523
FAC0037894;2015-03-16;CLI00388;FACTURA;28;1;141029;26796;167825
FAC0037895;2015-02-13;CLI00922;FACTURA;7;1;54486;10352;64838
FAC0037896;2015-11-06;CLI00503;FACTURA;34;2;227682;43260;270942
FAC0037897;2015-02-14;CLI00793;FACTURA;42;2;22206;4219;26425
FAC0037898;2015-09-16;CLI00933;FACTURA;35;2;25473;4840;30313
FAC0037899;2015-07-28;CLI00970;FACTURA;7;1;81729;15529;97258
FAC0037900;2015-07-19;CLI00779;FACTURA;6;2;97530;18531;116061
FAC0037901;2015-11-03;CLI00604;FACTURA;21;1;29003;5511;34514
FAC0037902;2015-10-12;CLI00317;FACTURA;12;2;145224;27593;172817
FAC0037903;2015-11-04;CLI00442;FACTURA;32;1;95718;18186;113904
FAC0037904;2015-02-07;CLI00211;FACTURA;6;2;17636;3351;20987
FAC0037905;2015-08-24;CLI00959;FACTURA;22;2;68619;13038;81657
FAC0037906;2015-02-17;CLI00614;FACTURA;20;1;101624;19309;120933
FAC0037907;2015-03-19;CLI00778;FACTURA;47;1;208260;39569;247829
FAC0037908;2015-06-29;CLI00970;FACTURA;28;1;243628;46289;289917
FAC0037909;2015-02-02;CLI00935;FACTURA;25;2;246130;46765;292895
FAC0037910;2015-02-16;CLI00413;FACTURA;29;2;65415;12429;77844
FAC0037911;2015-03-01;CLI00888;FACTURA;2;1;67917;12904;80821
FAC0037912;2015-12-21;CLI00413;FACTURA;13;2;12358;2348;14706
FAC0037913;2015-01-31;CLI00522;FACTURA;4;1;163458;31057;194515
FAC0037914;2015-04-18;CLI00452;FACTURA;29;1;50742;9641;60383
FAC0037915;2015-05-27;CLI00440;FACTURA;7;1;112952;21461;134413
FAC0037916;2015-03-07;CLI00959;FACTURA;3;2;290030;55106;345136
FAC0037917;2015-08-07;CLI00808;FACTURA;23;1;80588;15312;95900
FAC0037918;2015-07-02;CLI00219;FACTURA;30;2;161360;30658;192018
FAC0037919;2015-04-29;CLI00884;FACTURA;22;1;152436;28963;181399
FAC0037920;2015-09-17;CLI00840;FACTURA;16;1;87436;16613;104049
FAC0037921;2015-04-04;CLI00052;FACTURA;40;1;49226;9353;58579
FAC0037922;2015-09-27;CLI00196;FACTURA;1;1;232024;44085;276109
FAC0037923;2015-04-23;CLI00200;FACTURA;8;1;96816;18395;115211
FAC0037924;2015-11-30;CLI00371;FACTURA;46;2;80588;15312;95900
FAC0037925;2015-04-06;CLI00528;FACTURA;26;1;10146;1928;12074
FAC0037926;2015-06-17;CLI00893;FACTURA;30;2;116012;22042;138054
FAC0037927;2015-02-28;CLI00029;FACTURA;49;2;172291;32735;205026
FAC0037928;2015-05-28;CLI00047;FACTURA;48;2;20343;3865;24208
FAC0037929;2015-06-24;CLI00213;FACTURA;4;2;229257;43559;272816
FAC0037930;2015-11-06;CLI00324;FACTURA;8;1;173550;32975;206525
FAC0037931;2015-08-03;CLI00776;FACTURA;15;1;139216;26451;165667
FAC0037932;2015-06-03;CLI00117;FACTURA;33;2;57270;10881;68151
FAC0037933;2015-11-10;CLI00958;FACTURA;22;1;143340;27235;170575
FAC0037934;2015-12-08;CLI00737;FACTURA;13;2;64544;12263;76807
FAC0037935;2015-09-28;CLI00525;FACTURA;32;2;45746;8692;54438
FAC0037936;2015-07-02;CLI00072;FACTURA;44;1;136748;25982;162730
FAC0037937;2015-01-08;CLI00590;FACTURA;14;1;94485;17952;112437
FAC0037938;2015-08-12;CLI00968;FACTURA;48;1;68370;12990;81360
FAC0037939;2015-08-12;CLI00775;FACTURA;36;2;196777;37388;234165
FAC0037940;2015-04-15;CLI00252;FACTURA;20;1;196904;37412;234316
FAC0037941;2015-10-14;CLI00651;FACTURA;48;2;134388;25534;159922
FAC0037942;2015-11-21;CLI00984;FACTURA;19;1;210970;40084;251054
FAC0037943;2015-06-28;CLI00477;FACTURA;23;2;232024;44085;276109
FAC0037944;2015-09-20;CLI00511;FACTURA;25;2;182984;34767;217751
FAC0037945;2015-10-04;CLI00784;FACTURA;44;1;14334;2723;17057
FAC0037946;2015-05-29;CLI00544;FACTURA;7;1;15892;3019;18911
FAC0037947;2015-03-26;CLI00043;FACTURA;21;2;62874;11946;74820
FAC0037948;2015-12-11;CLI00903;FACTURA;28;2;100791;19150;119941
FAC0037949;2015-03-09;CLI00508;FACTURA;47;1;79749;15152;94901
FAC0037950;2015-03-06;CLI00322;FACTURA;21;1;163830;31128;194958
FAC0037951;2015-08-11;CLI00134;FACTURA;10;1;94460;17947;112407
FAC0037952;2015-04-16;CLI00666;FACTURA;26;1;30603;5815;36418
FAC0037953;2015-03-23;CLI00578;FACTURA;33;1;175554;33355;208909
FAC0037954;2015-11-20;CLI00685;FACTURA;17;2;80588;15312;95900
FAC0037955;2015-04-15;CLI00040;FACTURA;38;1;101532;19291;120823
FAC0037956;2015-01-15;CLI00714;FACTURA;50;1;32272;6132;38404
FAC0037957;2015-08-25;CLI00443;FACTURA;34;2;203430;38652;242082
FAC0037958;2015-09-14;CLI00907;FACTURA;10;2;85014;16153;101167
FAC0037959;2015-07-31;CLI00220;FACTURA;32;1;86004;16341;102345
FAC0037960;2015-10-06;CLI00874;FACTURA;8;1;37932;7207;45139
FAC0037961;2015-08-14;CLI00538;FACTURA;48;1;122058;23191;145249
FAC0037962;2015-05-17;CLI00125;FACTURA;6;2;83419;15850;99269
FAC0037963;2015-01-26;CLI00974;FACTURA;40;1;28668;5447;34115
FAC0037964;2015-01-29;CLI00005;FACTURA;50;2;137238;26075;163313
FAC0037965;2015-08-22;CLI00189;FACTURA;7;2;31784;6039;37823
FAC0037966;2015-04-22;CLI00174;FACTURA;44;1;65415;12429;77844
FAC0037967;2015-12-26;CLI00133;FACTURA;44;2;55418;10529;65947
FAC0037968;2015-07-07;CLI00497;FACTURA;33;2;27243;5176;32419
FAC0037969;2015-11-02;CLI00930;FACTURA;47;1;87436;16613;104049
FAC0037970;2015-11-20;CLI00203;FACTURA;32;2;11917;2264;14181
FAC0037971;2015-04-01;CLI00681;FACTURA;10;2;35751;6793;42544
FAC0037972;2015-05-04;CLI00344;FACTURA;31;1;34710;6595;41305
FAC0037973;2015-02-16;CLI00983;FACTURA;29;2;201582;38301;239883
FAC0037974;2015-12-02;CLI00990;FACTURA;3;1;147819;28086;175905
FAC0037975;2015-09-27;CLI00111;FACTURA;14;2;107050;20340;127390
FAC0037976;2015-10-30;CLI00046;FACTURA;16;1;42194;8017;50211
FAC0037977;2015-06-29;CLI00757;FACTURA;26;2;114540;21763;136303
FAC0037978;2015-09-08;CLI00360;FACTURA;46;1;114540;21763;136303
FAC0037979;2015-06-18;CLI00612;FACTURA;28;1;129088;24527;153615
FAC0037980;2015-10-24;CLI00144;FACTURA;18;1;132915;25254;158169
FAC0037981;2015-08-28;CLI00547;FACTURA;16;2;35751;6793;42544
FAC0037982;2015-04-24;CLI00449;FACTURA;47;2;178311;33879;212190
FAC0037983;2015-10-31;CLI00828;FACTURA;10;1;114540;21763;136303
FAC0037984;2015-12-08;CLI00620;FACTURA;8;1;112952;21461;134413
FAC0037985;2015-10-22;CLI00043;FACTURA;22;2;246130;46765;292895
FAC0037986;2015-12-17;CLI00982;FACTURA;25;1;28338;5384;33722
FAC0037987;2015-11-24;CLI00726;FACTURA;1;1;21805;4143;25948
FAC0037988;2015-05-08;CLI00762;FACTURA;50;1;20147;3828;23975
FAC0037989;2015-10-28;CLI00565;FACTURA;24;2;149870;28475;178345
FAC0037990;2015-08-05;CLI00153;FACTURA;26;2;24668;4687;29355
FAC0037991;2015-10-08;CLI00023;FACTURA;37;2;66381;12612;78993
FAC0037992;2015-05-24;CLI00335;FACTURA;22;2;30438;5783;36221
FAC0037993;2015-09-06;CLI00764;FACTURA;7;1;133236;25315;158551
FAC0037994;2015-11-04;CLI00356;FACTURA;44;1;47415;9009;56424
FAC0037995;2015-03-07;CLI00682;FACTURA;34;1;147819;28086;175905
FAC0037996;2015-11-12;CLI00377;FACTURA;13;2;278432;52902;331334
FAC0037997;2015-02-28;CLI00398;FACTURA;17;1;85014;16153;101167
FAC0037998;2015-07-15;CLI00991;FACTURA;39;2;312390;59354;371744
FAC0037999;2015-10-09;CLI00199;FACTURA;50;2;252999;48070;301069
FAC0038000;2015-10-09;CLI00025;FACTURA;18;2;80680;15329;96009
FAC0038001;2015-03-04;CLI00847;FACTURA;6;2;143340;27235;170575
FAC0038002;2015-06-11;CLI00305;FACTURA;8;2;167985;31917;199902
FAC0038003;2015-01-30;CLI00289;FACTURA;30;2;79460;15097;94557
FAC0038004;2015-02-04;CLI00740;FACTURA;15;1;23834;4528;28362
FAC0038005;2015-01-28;CLI00346;FACTURA;4;1;50766;9646;60412
FAC0038006;2015-06-04;CLI00667;FACTURA;32;2;25344;4815;30159
FAC0038007;2015-08-06;CLI00974;FACTURA;19;1;224888;42729;267617
FAC0038008;2015-12-20;CLI00377;FACTURA;10;2;177842;33790;211632
FAC0038009;2015-09-01;CLI00308;FACTURA;4;1;71670;13617;85287
FAC0038010;2015-10-18;CLI00340;FACTURA;9;1;281110;53411;334521
FAC0038011;2015-09-08;CLI00255;FACTURA;9;2;136542;25943;162485
FAC0038012;2015-07-22;CLI00988;FACTURA;48;1;94830;18018;112848
FAC0038013;2015-01-18;CLI00414;FACTURA;50;1;86004;16341;102345
FAC0038014;2015-06-11;CLI00558;FACTURA;22;1;25298;4807;30105
FAC0038015;2015-11-19;CLI00795;FACTURA;17;2;28111;5341;33452
FAC0038016;2015-11-27;CLI00365;FACTURA;34;2;43190;8206;51396
FAC0038017;2015-02-03;CLI00582;FACTURA;27;1;16914;3214;20128
FAC0038018;2015-07-03;CLI00463;FACTURA;14;2;10479;1991;12470
FAC0038019;2015-04-25;CLI00402;FACTURA;49;1;81213;15430;96643
FAC0038020;2015-12-09;CLI00697;FACTURA;23;2;199556;37916;237472
FAC0038021;2015-03-04;CLI00646;FACTURA;40;1;203021;38574;241595
FAC0038022;2015-11-09;CLI00063;FACTURA;5;2;30438;5783;36221
FAC0038023;2015-03-01;CLI00058;FACTURA;43;1;196777;37388;234165
FAC0038024;2015-01-14;CLI00862;FACTURA;39;1;54486;10352;64838
FAC0038025;2015-07-21;CLI00057;FACTURA;23;2;135376;25721;161097
FAC0038026;2015-07-08;CLI00377;FACTURA;37;2;138840;26380;165220
FAC0038027;2015-07-09;CLI00372;FACTURA;42;1;104130;19785;123915
FAC0038028;2015-11-27;CLI00331;FACTURA;29;2;143340;27235;170575
FAC0038029;2015-03-08;CLI00527;FACTURA;8;2;243639;46291;289930
FAC0038030;2015-04-25;CLI00674;FACTURA;42;1;40686;7730;48416
FAC0038031;2015-03-03;CLI00334;FACTURA;40;1;33828;6427;40255
FAC0038032;2015-08-25;CLI00443;FACTURA;49;2;141088;26807;167895
FAC0038033;2015-08-07;CLI00089;FACTURA;4;2;110836;21059;131895
FAC0038034;2015-01-23;CLI00543;FACTURA;18;2;74004;14061;88065
FAC0038035;2015-10-10;CLI00411;FACTURA;37;2;109295;20766;130061
FAC0038036;2015-09-10;CLI00274;FACTURA;10;1;243639;46291;289930
FAC0038037;2015-02-06;CLI00767;FACTURA;10;2;28508;5417;33925
FAC0038038;2015-03-22;CLI00497;FACTURA;16;2;222012;42182;264194
FAC0038039;2015-02-05;CLI00451;FACTURA;27;2;105585;20061;125646
FAC0038040;2015-01-29;CLI00669;FACTURA;7;2;162744;30921;193665
FAC0038041;2015-02-20;CLI00174;FACTURA;50;1;33828;6427;40255
FAC0038042;2015-10-16;CLI00499;FACTURA;38;2;27071;5143;32214
FAC0038043;2015-03-14;CLI00047;FACTURA;28;2;33792;6420;40212
FAC0038044;2015-02-06;CLI00260;FACTURA;34;1;27071;5143;32214
FAC0038045;2015-03-17;CLI00287;FACTURA;43;2;137238;26075;163313
FAC0038046;2015-11-05;CLI00246;FACTURA;34;1;104790;19910;124700
FAC0038047;2015-10-05;CLI00878;FACTURA;18;1;158473;30110;188583
FAC0038048;2015-04-03;CLI00488;FACTURA;35;1;169220;32152;201372
FAC0038049;2015-12-24;CLI00543;FACTURA;38;2;228064;43332;271396
FAC0038050;2015-09-07;CLI00970;FACTURA;45;1;67584;12841;80425
FAC0038051;2015-08-25;CLI00770;FACTURA;45;1;268776;51067;319843
FAC0038052;2015-07-24;CLI00099;FACTURA;14;2;50730;9639;60369
FAC0038053;2015-11-05;CLI00954;FACTURA;19;1;170073;32314;202387
FAC0038054;2015-10-10;CLI00214;FACTURA;39;1;98298;18677;116975
FAC0038055;2015-10-23;CLI00423;FACTURA;45;2;83419;15850;99269
FAC0038056;2015-01-03;CLI00710;FACTURA;5;1;57016;10833;67849
FAC0038057;2015-01-26;CLI00005;FACTURA;28;2;160350;30467;190817
FAC0038058;2015-02-15;CLI00967;FACTURA;16;2;104130;19785;123915
FAC0038059;2015-07-29;CLI00794;FACTURA;46;1;245187;46586;291773
FAC0038060;2015-06-16;CLI00417;FACTURA;16;2;210970;40084;251054
FAC0038061;2015-10-05;CLI00995;FACTURA;25;2;218590;41532;260122
FAC0038062;2015-04-14;CLI00941;FACTURA;28;2;27709;5265;32974
FAC0038063;2015-11-05;CLI00618;FACTURA;48;1;218050;41430;259480
FAC0038064;2015-05-14;CLI00069;FACTURA;11;2;228654;43444;272098
FAC0038065;2015-06-08;CLI00633;FACTURA;44;2;173550;32975;206525
FAC0038066;2015-02-14;CLI00738;FACTURA;30;1;84610;16076;100686
FAC0038067;2015-11-08;CLI00483;FACTURA;32;2;30438;5783;36221
FAC0038068;2015-05-15;CLI00776;FACTURA;25;1;52908;10053;62961
FAC0038069;2015-02-08;CLI00628;FACTURA;9;1;186081;35355;221436
FAC0038070;2015-06-15;CLI00496;FACTURA;34;1;277680;52759;330439
FAC0038071;2015-10-27;CLI00372;FACTURA;8;1;53166;10102;63268
FAC0038072;2015-03-01;CLI00468;FACTURA;20;1;78024;14825;92849
FAC0038073;2015-04-06;CLI00975;FACTURA;49;2;22552;4285;26837
FAC0038074;2015-04-21;CLI00815;FACTURA;12;2;81372;15461;96833
FAC0038075;2015-02-07;CLI00674;FACTURA;7;1;67194;12767;79961
FAC0038076;2015-10-06;CLI00954;FACTURA;14;1;175554;33355;208909
FAC0038077;2015-12-31;CLI00428;FACTURA;47;1;68619;13038;81657
FAC0038078;2015-01-10;CLI00883;FACTURA;2;2;41916;7964;49880
FAC0038079;2015-12-04;CLI00704;FACTURA;32;1;155442;29534;184976
FAC0038080;2015-07-18;CLI00553;FACTURA;20;2;176360;33508;209868
FAC0038081;2015-01-10;CLI00328;FACTURA;27;1;211170;40122;251292
FAC0038082;2015-09-23;CLI00462;FACTURA;36;1;130830;24858;155688
FAC0038083;2015-10-06;CLI00436;FACTURA;46;1;167985;31917;199902
FAC0038084;2015-03-05;CLI00450;FACTURA;6;1;189497;36004;225501
FAC0038085;2015-12-23;CLI00693;FACTURA;12;2;11454;2176;13630
FAC0038086;2015-09-08;CLI00343;FACTURA;47;2;34804;6613;41417
FAC0038087;2015-09-26;CLI00390;FACTURA;30;1;42194;8017;50211
FAC0038088;2015-04-18;CLI00958;FACTURA;17;1;12358;2348;14706
FAC0038089;2015-10-31;CLI00634;FACTURA;31;1;273496;51964;325460
FAC0038090;2015-08-21;CLI00109;FACTURA;50;2;174018;33063;207081
FAC0038091;2015-12-12;CLI00370;FACTURA;18;1;100338;19064;119402
FAC0038092;2015-04-01;CLI00477;FACTURA;21;2;202384;38453;240837
FAC0038093;2015-05-16;CLI00705;FACTURA;19;2;87436;16613;104049
FAC0038094;2015-06-20;CLI00841;FACTURA;5;2;130830;24858;155688
FAC0038095;2015-03-19;CLI00917;FACTURA;11;2;56676;10768;67444
FAC0038096;2015-11-11;CLI00132;FACTURA;23;1;218590;41532;260122
FAC0038097;2015-12-24;CLI00849;FACTURA;1;2;37020;7034;44054
FAC0038098;2015-08-20;CLI00256;FACTURA;22;1;28449;5405;33854
FAC0038099;2015-04-01;CLI00775;FACTURA;48;2;144315;27420;171735
FAC0038100;2015-07-01;CLI00183;FACTURA;48;2;285080;54165;339245
FAC0038101;2015-06-29;CLI00314;FACTURA;22;1;24716;4696;29412
FAC0038102;2015-06-07;CLI00965;FACTURA;35;2;138840;26380;165220
FAC0038103;2015-03-30;CLI00890;FACTURA;43;1;68374;12991;81365
FAC0038104;2015-07-18;CLI00859;FACTURA;13;2;141029;26796;167825
FAC0038105;2015-12-13;CLI00704;FACTURA;27;1;152838;29039;181877
FAC0038106;2015-10-07;CLI00161;FACTURA;16;2;341870;64955;406825
FAC0038107;2015-09-27;CLI00430;FACTURA;16;1;56380;10712;67092
FAC0038108;2015-02-24;CLI00649;FACTURA;23;2;103086;19586;122672
FAC0038109;2015-01-07;CLI00019;FACTURA;27;2;131064;24902;155966
FAC0038110;2015-05-30;CLI00327;FACTURA;45;2;252999;48070;301069
FAC0038111;2015-09-09;CLI00147;FACTURA;23;2;133236;25315;158551
FAC0038112;2015-04-16;CLI00374;FACTURA;12;1;107050;20340;127390
FAC0038113;2015-07-19;CLI00983;FACTURA;20;2;188970;35904;224874
FAC0038114;2015-06-11;CLI00029;FACTURA;8;2;189873;36076;225949
FAC0038115;2015-02-18;CLI00388;FACTURA;3;1;11454;2176;13630
FAC0038116;2015-06-07;CLI00545;FACTURA;50;2;103086;19586;122672
FAC0038117;2015-10-11;CLI00652;FACTURA;9;1;256572;48749;305321
FAC0038118;2015-10-09;CLI00940;FACTURA;36;1;6170;1172;7342
FAC0038119;2015-01-08;CLI00955;FACTURA;28;2;41916;7964;49880
FAC0038120;2015-11-10;CLI00124;FACTURA;24;1;114672;21788;136460
FAC0038121;2015-08-05;CLI00632;FACTURA;29;1;34362;6529;40891
FAC0038122;2015-08-07;CLI00084;FACTURA;6;1;78024;14825;92849
FAC0038123;2015-03-30;CLI00939;FACTURA;14;2;45746;8692;54438
FAC0038124;2015-05-20;CLI00063;FACTURA;35;2;24680;4689;29369
FAC0038125;2015-05-19;CLI00535;FACTURA;38;2;163830;31128;194958
FAC0038126;2015-07-22;CLI00782;FACTURA;24;1;120882;22968;143850
FAC0038127;2015-01-31;CLI00489;FACTURA;13;2;205857;39113;244970
FAC0038128;2015-01-09;CLI00666;FACTURA;48;1;197344;37495;234839
FAC0038129;2015-01-19;CLI00140;FACTURA;42;1;147678;28059;175737
FAC0038130;2015-12-22;CLI00400;FACTURA;45;1;133236;25315;158551
FAC0038131;2015-09-15;CLI00035;FACTURA;25;2;81372;15461;96833
FAC0038132;2015-09-14;CLI00669;FACTURA;11;2;39730;7549;47279
FAC0038133;2015-02-05;CLI00903;FACTURA;39;2;71670;13617;85287
FAC0038134;2015-02-13;CLI00314;FACTURA;8;1;55622;10568;66190
FAC0038135;2015-05-17;CLI00471;FACTURA;48;2;29003;5511;34514
FAC0038136;2015-03-06;CLI00662;FACTURA;21;1;145224;27593;172817
FAC0038137;2015-09-19;CLI00466;FACTURA;36;1;104790;19910;124700
FAC0038138;2015-12-13;CLI00533;FACTURA;39;2;136748;25982;162730
FAC0038139;2015-04-27;CLI00555;FACTURA;47;2;108284;20574;128858
FAC0038140;2015-07-17;CLI00493;FACTURA;2;2;196245;37287;233532
FAC0038141;2015-07-29;CLI00088;FACTURA;16;1;181112;34411;215523
FAC0038142;2015-06-03;CLI00003;FACTURA;42;2;199556;37916;237472
FAC0038143;2015-09-30;CLI00884;FACTURA;25;1;94830;18018;112848
FAC0038144;2015-03-25;CLI00246;FACTURA;5;1;33844;6430;40274
FAC0038145;2015-02-14;CLI00080;FACTURA;30;1;178311;33879;212190
FAC0038146;2015-09-03;CLI00049;FACTURA;36;2;9483;1802;11285
FAC0038147;2015-07-18;CLI00230;FACTURA;48;1;107050;20340;127390
FAC0038148;2015-04-15;CLI00058;FACTURA;8;1;222012;42182;264194
FAC0038149;2015-05-07;CLI00306;FACTURA;47;1;16896;3210;20106
FAC0038150;2015-12-18;CLI00523;FACTURA;18;2;126490;24033;150523
FAC0038151;2015-09-25;CLI00029;FACTURA;22;2;49226;9353;58579
FAC0038152;2015-05-01;CLI00688;FACTURA;26;1;42240;8026;50266
FAC0038153;2015-05-14;CLI00080;FACTURA;3;1;80680;15329;96009
FAC0038154;2015-08-05;CLI00622;FACTURA;49;1;14334;2723;17057
FAC0038155;2015-09-02;CLI00409;FACTURA;27;2;163458;31057;194515
FAC0038156;2015-11-15;CLI00048;FACTURA;48;1;302373;57451;359824
FAC0038157;2015-09-30;CLI00376;FACTURA;44;1;104130;19785;123915
FAC0038158;2015-08-24;CLI00801;FACTURA;25;2;196777;37388;234165
FAC0038159;2015-05-10;CLI00742;FACTURA;47;1;20147;3828;23975
FAC0038160;2015-01-23;CLI00613;FACTURA;44;2;20402;3876;24278
FAC0038161;2015-02-13;CLI00034;FACTURA;48;1;81608;15506;97114
FAC0038162;2015-01-06;CLI00866;FACTURA;26;1;224888;42729;267617
FAC0038163;2015-03-26;CLI00909;FACTURA;37;2;69608;13226;82834
FAC0038164;2015-04-23;CLI00774;FACTURA;23;1;30438;5783;36221
FAC0038165;2015-06-15;CLI00331;FACTURA;35;2;110836;21059;131895
FAC0038166;2015-11-11;CLI00107;FACTURA;3;2;55611;10566;66177
FAC0038167;2015-04-22;CLI00600;FACTURA;38;1;39466;7499;46965
FAC0038168;2015-05-07;CLI00819;FACTURA;21;2;160111;30421;190532
FAC0038169;2015-03-08;CLI00897;FACTURA;47;2;196245;37287;233532
FAC0038170;2015-02-04;CLI00757;FACTURA;50;2;140555;26705;167260
FAC0038171;2015-06-06;CLI00536;FACTURA;7;1;66618;12657;79275
FAC0038172;2015-07-09;CLI00258;FACTURA;4;1;11276;2142;13418
FAC0038173;2015-01-23;CLI00238;FACTURA;5;1;139216;26451;165667
FAC0038174;2015-06-04;CLI00562;FACTURA;43;1;138840;26380;165220
FAC0038175;2015-11-28;CLI00998;FACTURA;50;1;186081;35355;221436
FAC0038176;2015-06-19;CLI00086;FACTURA;15;1;113382;21543;134925
FAC0038177;2015-10-01;CLI00732;FACTURA;12;1;147679;28059;175738
FAC0038178;2015-04-16;CLI00684;FACTURA;9;1;16922;3215;20137
FAC0038179;2015-11-09;CLI00500;FACTURA;17;1;70544;13403;83947
FAC0038180;2015-07-10;CLI00186;FACTURA;2;1;218050;41430;259480
FAC0038181;2015-02-18;CLI00341;FACTURA;41;2;186081;35355;221436
FAC0038182;2015-10-25;CLI00799;FACTURA;31;2;252999;48070;301069
FAC0038183;2015-06-17;CLI00269;FACTURA;11;2;21410;4068;25478
FAC0038184;2015-11-03;CLI00066;FACTURA;29;1;211170;40122;251292
FAC0038185;2015-02-07;CLI00601;FACTURA;39;2;176360;33508;209868
FAC0038186;2015-01-30;CLI00545;FACTURA;3;2;34362;6529;40891
FAC0038187;2015-11-03;CLI00970;FACTURA;43;1;24716;4696;29412
FAC0038188;2015-03-06;CLI00787;FACTURA;28;2;55622;10568;66190
FAC0038189;2015-10-27;CLI00150;FACTURA;19;1;94485;17952;112437
FAC0038190;2015-09-05;CLI00542;FACTURA;40;1;9483;1802;11285
FAC0038191;2015-11-03;CLI00679;FACTURA;6;2;20147;3828;23975
FAC0038192;2015-07-11;CLI00114;FACTURA;7;1;76419;14520;90939
FAC0038193;2015-12-24;CLI00318;FACTURA;35;1;61700;11723;73423
FAC0038194;2015-09-13;CLI00473;FACTURA;22;2;196777;37388;234165
FAC0038195;2015-11-02;CLI00490;FACTURA;41;1;252999;48070;301069
FAC0038196;2015-10-20;CLI00419;FACTURA;44;2;252980;48066;301046
FAC0038197;2015-07-01;CLI00011;FACTURA;45;2;44412;8438;52850
FAC0038198;2015-09-27;CLI00813;FACTURA;4;2;183087;34787;217874
FAC0038199;2015-05-01;CLI00377;FACTURA;13;2;69420;13190;82610
FAC0038200;2015-06-13;CLI00622;FACTURA;43;1;126490;24033;150523
FAC0038201;2015-02-15;CLI00811;FACTURA;32;2;135355;25717;161072
FAC0038202;2015-08-20;CLI00028;FACTURA;34;1;136748;25982;162730
FAC0038203;2015-04-27;CLI00386;FACTURA;21;1;5638;1071;6709
FAC0038204;2015-03-30;CLI00877;FACTURA;25;2;138545;26324;164869
FAC0038205;2015-01-07;CLI00039;FACTURA;2;2;81213;15430;96643
FAC0038206;2015-09-21;CLI00656;FACTURA;22;1;218050;41430;259480
FAC0038207;2015-09-14;CLI00996;FACTURA;8;1;109295;20766;130061
FAC0038208;2015-12-31;CLI00879;FACTURA;39;2;152838;29039;181877
FAC0038209;2015-05-18;CLI00586;FACTURA;42;1;28668;5447;34115
FAC0038210;2015-10-08;CLI00523;FACTURA;28;2;42240;8026;50266
FAC0038211;2015-01-08;CLI00977;FACTURA;29;2;17636;3351;20987
FAC0038212;2015-03-08;CLI00236;FACTURA;25;1;261027;49595;310622
FAC0038213;2015-06-26;CLI00677;FACTURA;27;2;201582;38301;239883
FAC0038214;2015-07-25;CLI00352;FACTURA;3;1;114672;21788;136460
FAC0038215;2015-11-30;CLI00254;FACTURA;48;1;201470;38279;239749
FAC0038216;2015-01-25;CLI00248;FACTURA;12;1;10201;1938;12139
FAC0038217;2015-12-25;CLI00014;FACTURA;20;1;203430;38652;242082
FAC0038218;2015-01-11;CLI00558;FACTURA;10;1;127030;24136;151166
FAC0038219;2015-12-21;CLI00523;FACTURA;9;2;34710;6595;41305
FAC0038220;2015-07-04;CLI00287;FACTURA;31;2;35751;6793;42544
FAC0038221;2015-06-26;CLI00355;FACTURA;26;2;134388;25534;159922
FAC0038222;2015-02-26;CLI00509;FACTURA;34;2;201470;38279;239749
FAC0038223;2015-06-22;CLI00729;FACTURA;10;2;129088;24527;153615
FAC0038224;2015-12-13;CLI00266;FACTURA;10;1;196904;37412;234316
FAC0038225;2015-11-17;CLI00626;FACTURA;33;1;109392;20784;130176
FAC0038226;2015-12-01;CLI00398;FACTURA;7;1;193963;36853;230816
FAC0038227;2015-04-30;CLI00401;FACTURA;29;2;11454;2176;13630
FAC0038228;2015-03-08;CLI00607;FACTURA;1;2;133236;25315;158551
FAC0038229;2015-12-27;CLI00269;FACTURA;41;2;136215;25881;162096
FAC0038230;2015-12-26;CLI00468;FACTURA;4;1;54142;10287;64429
FAC0038231;2015-07-15;CLI00176;FACTURA;23;1;214100;40679;254779
FAC0038232;2015-05-13;CLI00525;FACTURA;45;2;100735;19140;119875
FAC0038233;2015-09-09;CLI00668;FACTURA;32;1;112952;21461;134413
FAC0038234;2015-09-01;CLI00740;FACTURA;32;1;196777;37388;234165
FAC0038235;2015-12-24;CLI00500;FACTURA;23;1;75864;14414;90278
FAC0038236;2015-08-29;CLI00981;FACTURA;19;2;34804;6613;41417
FAC0038237;2015-12-27;CLI00563;FACTURA;44;2;18892;3589;22481
FAC0038238;2015-04-10;CLI00716;FACTURA;5;1;148008;28122;176130
FAC0038239;2015-07-24;CLI00349;FACTURA;25;2;94830;18018;112848
FAC0038240;2015-05-27;CLI00578;FACTURA;13;1;174020;33064;207084
FAC0038241;2015-10-05;CLI00372;FACTURA;45;1;224888;42729;267617
FAC0038242;2015-10-26;CLI00057;FACTURA;10;2;112952;21461;134413
FAC0038243;2015-04-30;CLI00234;FACTURA;47;1;126702;24073;150775
FAC0038244;2015-08-17;CLI00107;FACTURA;36;2;277680;52759;330439
FAC0038245;2015-03-22;CLI00593;FACTURA;39;2;161176;30623;191799
FAC0038246;2015-04-05;CLI00957;FACTURA;44;2;105485;20042;125527
FAC0038247;2015-05-11;CLI00546;FACTURA;14;1;252999;48070;301069
FAC0038248;2015-04-14;CLI00224;FACTURA;39;1;85014;16153;101167
FAC0038249;2015-07-31;CLI00535;FACTURA;26;2;103086;19586;122672
FAC0038250;2015-02-12;CLI00911;FACTURA;23;2;98298;18677;116975
FAC0038251;2015-07-25;CLI00040;FACTURA;30;1;18510;3517;22027
FAC0038252;2015-09-10;CLI00653;FACTURA;19;2;140555;26705;167260
FAC0038253;2015-09-10;CLI00439;FACTURA;9;2;91632;17410;109042
FAC0038254;2015-04-29;CLI00668;FACTURA;2;1;147819;28086;175905
FAC0038255;2015-07-13;CLI00280;FACTURA;18;1;216568;41148;257716
FAC0038256;2015-02-28;CLI00215;FACTURA;4;2;96816;18395;115211
FAC0038257;2015-07-05;CLI00874;FACTURA;35;1;144315;27420;171735
FAC0038258;2015-03-18;CLI00714;FACTURA;45;1;196596;37353;233949
FAC0038259;2015-01-08;CLI00028;FACTURA;30;1;176360;33508;209868
FAC0038260;2015-05-28;CLI00403;FACTURA;44;2;129006;24511;153517
FAC0038261;2015-05-16;CLI00939;FACTURA;37;2;33597;6383;39980
FAC0038262;2015-05-18;CLI00986;FACTURA;32;1;147819;28086;175905
FAC0038263;2015-05-29;CLI00009;FACTURA;34;2;25406;4827;30233
FAC0038264;2015-11-28;CLI00232;FACTURA;2;1;80175;15233;95408
FAC0038265;2015-12-05;CLI00090;FACTURA;27;1;94830;18018;112848
FAC0038266;2015-06-29;CLI00680;FACTURA;8;1;104412;19838;124250
FAC0038267;2015-07-07;CLI00415;FACTURA;25;2;152838;29039;181877
FAC0038268;2015-11-28;CLI00111;FACTURA;18;2;176360;33508;209868
FAC0038269;2015-12-05;CLI00142;FACTURA;20;1;47676;9058;56734
FAC0038270;2015-06-07;CLI00255;FACTURA;29;2;41022;7794;48816
FAC0038271;2015-01-31;CLI00207;FACTURA;13;2;262128;49804;311932
FAC0038272;2015-06-18;CLI00338;FACTURA;12;1;203784;38719;242503
FAC0038273;2015-12-13;CLI00821;FACTURA;3;2;347100;65949;413049
FAC0038274;2015-08-03;CLI00073;FACTURA;19;2;112444;21364;133808
FAC0038275;2015-11-10;CLI00831;FACTURA;10;2;199854;37972;237826
FAC0038276;2015-08-13;CLI00441;FACTURA;12;2;101532;19291;120823
FAC0038277;2015-03-10;CLI00023;FACTURA;22;2;21805;4143;25948
FAC0038278;2015-08-23;CLI00125;FACTURA;6;2;123066;23383;146449
FAC0038279;2015-03-03;CLI00485;FACTURA;20;2;66381;12612;78993
FAC0038280;2015-07-31;CLI00100;FACTURA;21;1;47230;8974;56204
FAC0038281;2015-05-23;CLI00659;FACTURA;3;2;151176;28723;179899
FAC0038282;2015-10-14;CLI00303;FACTURA;8;2;14334;2723;17057
FAC0038283;2015-06-18;CLI00331;FACTURA;27;2;55622;10568;66190
FAC0038284;2015-07-15;CLI00916;FACTURA;45;1;127365;24199;151564
FAC0038285;2015-07-01;CLI00890;FACTURA;38;1;189497;36004;225501
FAC0038286;2015-07-18;CLI00189;FACTURA;33;2;48105;9140;57245
FAC0038287;2015-04-01;CLI00020;FACTURA;4;1;158724;30158;188882
FAC0038288;2015-10-09;CLI00272;FACTURA;37;1;188970;35904;224874
FAC0038289;2015-10-14;CLI00765;FACTURA;3;2;47668;9057;56725
FAC0038290;2015-01-11;CLI00839;FACTURA;48;2;137238;26075;163313
FAC0038291;2015-11-21;CLI00488;FACTURA;37;1;96816;18395;115211
FAC0038292;2015-10-04;CLI00371;FACTURA;31;2;145015;27553;172568
FAC0038293;2015-01-14;CLI00992;FACTURA;21;1;218590;41532;260122
FAC0038294;2015-02-18;CLI00476;FACTURA;21;1;129088;24527;153615
FAC0038295;2015-02-13;CLI00097;FACTURA;48;2;10146;1928;12074
FAC0038296;2015-09-04;CLI00512;FACTURA;17;1;16035;3047;19082
FAC0038297;2015-06-22;CLI00814;FACTURA;16;1;228730;43459;272189
FAC0038298;2015-03-30;CLI00841;FACTURA;10;2;103086;19586;122672
FAC0038299;2015-04-06;CLI00750;FACTURA;9;1;66122;12563;78685
FAC0038300;2015-06-07;CLI00567;FACTURA;39;2;126582;24051;150633
FAC0038301;2015-10-08;CLI00128;FACTURA;41;1;216568;41148;257716
FAC0038302;2015-09-05;CLI00913;FACTURA;6;2;33828;6427;40255
FAC0038303;2015-08-17;CLI00574;FACTURA;23;1;163458;31057;194515
FAC0038304;2015-08-29;CLI00202;FACTURA;21;1;285080;54165;339245
FAC0038305;2015-01-16;CLI00514;FACTURA;26;1;162426;30861;193287
FAC0038306;2015-04-12;CLI00814;FACTURA;41;1;183087;34787;217874
FAC0038307;2015-11-04;CLI00995;FACTURA;24;2;24680;4689;29369
FAC0038308;2015-02-11;CLI00069;FACTURA;15;2;51005;9691;60696
FAC0038309;2015-07-09;CLI00634;FACTURA;30;1;23838;4529;28367
FAC0038310;2015-05-18;CLI00871;FACTURA;49;2;106332;20203;126535
FAC0038311;2015-02-23;CLI00308;FACTURA;23;1;71514;13588;85102
FAC0038312;2015-09-01;CLI00588;FACTURA;8;1;107253;20378;127631
FAC0038313;2015-10-29;CLI00577;FACTURA;36;2;101460;19277;120737
FAC0038314;2015-02-14;CLI00060;FACTURA;26;1;39012;7412;46424
FAC0038315;2015-08-11;CLI00768;FACTURA;26;1;114540;21763;136303
FAC0038316;2015-04-20;CLI00739;FACTURA;29;2;227682;43260;270942
FAC0038317;2015-03-28;CLI00270;FACTURA;19;1;71022;13494;84516
FAC0038318;2015-12-08;CLI00799;FACTURA;6;2;43002;8170;51172
FAC0038319;2015-01-04;CLI00149;FACTURA;43;2;75588;14362;89950
FAC0038320;2015-09-06;CLI00739;FACTURA;4;2;43610;8286;51896
FAC0038321;2015-02-02;CLI00875;FACTURA;15;2;37932;7207;45139
FAC0038322;2015-08-04;CLI00096;FACTURA;19;1;203751;38713;242464
FAC0038323;2015-03-24;CLI00785;FACTURA;28;2;235179;44684;279863
FAC0038324;2015-03-22;CLI00370;FACTURA;31;1;102010;19382;121392
FAC0038325;2015-07-04;CLI00558;FACTURA;38;1;28508;5417;33925
FAC0038326;2015-12-20;CLI00389;FACTURA;34;2;81168;15422;96590
FAC0038327;2015-08-18;CLI00027;FACTURA;14;2;18537;3522;22059
FAC0038328;2015-09-08;CLI00772;FACTURA;39;1;172676;32808;205484
FAC0038329;2015-08-01;CLI00060;FACTURA;38;1;294894;56030;350924
FAC0038330;2015-10-29;CLI00254;FACTURA;31;1;45104;8570;53674
FAC0038331;2015-01-20;CLI00952;FACTURA;16;1;277090;52647;329737
FAC0038332;2015-08-30;CLI00512;FACTURA;29;1;34710;6595;41305
FAC0038333;2015-09-07;CLI00933;FACTURA;14;2;168776;32067;200843
FAC0038334;2015-10-05;CLI00751;FACTURA;42;2;169220;32152;201372
FAC0038335;2015-07-27;CLI00749;FACTURA;46;2;272430;51762;324192
FAC0038336;2015-07-07;CLI00468;FACTURA;28;1;76218;14481;90699
FAC0038337;2015-11-26;CLI00797;FACTURA;10;2;37784;7179;44963
FAC0038338;2015-07-27;CLI00242;FACTURA;40;1;123452;23456;146908
FAC0038339;2015-09-04;CLI00289;FACTURA;44;2;34804;6613;41417
FAC0038340;2015-02-20;CLI00989;FACTURA;13;2;145015;27553;172568
FAC0038341;2015-12-15;CLI00145;FACTURA;39;2;152838;29039;181877
FAC0038342;2015-01-10;CLI00572;FACTURA;35;1;156048;29649;185697
FAC0038343;2015-02-01;CLI00938;FACTURA;13;1;76032;14446;90478
FAC0038344;2015-07-05;CLI00838;FACTURA;21;1;52908;10053;62961
FAC0038345;2015-05-12;CLI00681;FACTURA;8;2;273496;51964;325460
FAC0038346;2015-11-05;CLI00279;FACTURA;21;2;56898;10811;67709
FAC0038347;2015-12-26;CLI00656;FACTURA;23;1;254730;48399;303129
FAC0038348;2015-03-22;CLI00819;FACTURA;13;2;45746;8692;54438
FAC0038349;2015-02-24;CLI00177;FACTURA;49;2;211170;40122;251292
FAC0038350;2015-07-24;CLI00249;FACTURA;34;2;74004;14061;88065
FAC0038351;2015-11-07;CLI00886;FACTURA;25;1;21859;4153;26012
FAC0038352;2015-01-29;CLI00076;FACTURA;50;1;163458;31057;194515
FAC0038353;2015-01-19;CLI00200;FACTURA;20;1;196777;37388;234165
FAC0038354;2015-02-01;CLI00766;FACTURA;27;1;195060;37061;232121
FAC0038355;2015-01-10;CLI00635;FACTURA;48;2;16922;3215;20137
FAC0038356;2015-01-15;CLI00029;FACTURA;15;2;98452;18706;117158
FAC0038357;2015-01-02;CLI00930;FACTURA;47;1;37074;7044;44118
FAC0038358;2015-04-11;CLI00047;FACTURA;13;2;50688;9631;60319
FAC0038359;2015-02-12;CLI00502;FACTURA;6;1;143340;27235;170575
FAC0038360;2015-11-19;CLI00970;FACTURA;23;1;85640;16272;101912
FAC0038361;2015-12-20;CLI00997;FACTURA;4;2;84388;16034;100422
FAC0038362;2015-08-18;CLI00960;FACTURA;12;1;35272;6702;41974
FAC0038363;2015-10-09;CLI00719;FACTURA;30;2;262128;49804;311932
FAC0038364;2015-01-12;CLI00026;FACTURA;9;1;145224;27593;172817
FAC0038365;2015-01-20;CLI00572;FACTURA;38;1;40294;7656;47950
FAC0038366;2015-06-12;CLI00339;FACTURA;37;2;172676;32808;205484
FAC0038367;2015-09-29;CLI00414;FACTURA;27;1;98298;18677;116975
FAC0038368;2015-02-28;CLI00443;FACTURA;2;2;64230;12204;76434
FAC0038369;2015-12-22;CLI00935;FACTURA;38;2;86004;16341;102345
FAC0038370;2015-12-25;CLI00514;FACTURA;7;1;190053;36110;226163
FAC0038371;2015-11-17;CLI00748;FACTURA;27;1;37074;7044;44118
FAC0038372;2015-02-26;CLI00738;FACTURA;29;1;84480;16051;100531
FAC0038373;2015-01-24;CLI00455;FACTURA;37;2;135834;25808;161642
FAC0038374;2015-12-13;CLI00629;FACTURA;37;2;79749;15152;94901
FAC0038375;2015-12-31;CLI00400;FACTURA;40;1;140555;26705;167260
FAC0038376;2015-04-28;CLI00088;FACTURA;8;1;71514;13588;85102
FAC0038377;2015-06-20;CLI00056;FACTURA;34;1;55611;10566;66177
FAC0038378;2015-05-21;CLI00834;FACTURA;10;1;147679;28059;175738
FAC0038379;2015-11-26;CLI00207;FACTURA;20;2;62874;11946;74820
FAC0038380;2015-09-15;CLI00099;FACTURA;2;2;170935;32478;203413
FAC0038381;2015-09-22;CLI00418;FACTURA;34;1;101892;19359;121251
FAC0038382;2015-01-17;CLI00730;FACTURA;9;1;170935;32478;203413
FAC0038383;2015-02-19;CLI00051;FACTURA;26;2;27709;5265;32974
FAC0038384;2015-03-20;CLI00998;FACTURA;45;1;254730;48399;303129
FAC0038385;2015-03-18;CLI00167;FACTURA;1;2;136740;25981;162721
FAC0038386;2015-06-27;CLI00390;FACTURA;42;1;168936;32098;201034
FAC0038387;2015-07-23;CLI00950;FACTURA;8;1;118454;22506;140960
FAC0038388;2015-09-30;CLI00093;FACTURA;41;2;52395;9955;62350
FAC0038389;2015-05-16;CLI00249;FACTURA;4;2;273496;51964;325460
FAC0038390;2015-02-27;CLI00655;FACTURA;8;2;22206;4219;26425
FAC0038391;2015-05-23;CLI00711;FACTURA;42;2;71670;13617;85287
FAC0038392;2015-11-22;CLI00001;FACTURA;16;2;75894;14420;90314
FAC0038393;2015-09-02;CLI00881;FACTURA;3;2;135376;25721;161097
FAC0038394;2015-08-02;CLI00867;FACTURA;45;2;56222;10682;66904
FAC0038395;2015-11-24;CLI00477;FACTURA;28;2;47668;9057;56725
FAC0038396;2015-05-03;CLI00363;FACTURA;34;2;113382;21543;134925
FAC0038397;2015-05-20;CLI00855;FACTURA;6;2;52908;10053;62961
FAC0038398;2015-12-03;CLI00429;FACTURA;9;2;139216;26451;165667
FAC0038399;2015-08-06;CLI00732;FACTURA;21;1;64230;12204;76434
FAC0038400;2015-09-15;CLI00711;FACTURA;5;2;129088;24527;153615
FAC0038401;2015-09-08;CLI00231;FACTURA;44;2;28190;5356;33546
FAC0038402;2015-05-08;CLI00436;FACTURA;6;1;34362;6529;40891
FAC0038403;2015-06-02;CLI00484;FACTURA;27;1;127030;24136;151166
FAC0038404;2015-10-16;CLI00209;FACTURA;31;2;174020;33064;207084
FAC0038405;2015-03-04;CLI00045;FACTURA;42;2;61790;11740;73530
FAC0038406;2015-03-12;CLI00356;FACTURA;40;1;113382;21543;134925
FAC0038407;2015-07-22;CLI00300;FACTURA;35;1;127365;24199;151564
FAC0038408;2015-08-11;CLI00150;FACTURA;20;1;153013;29072;182085
FAC0038409;2015-11-04;CLI00219;FACTURA;16;2;30603;5815;36418
FAC0038410;2015-03-26;CLI00010;FACTURA;18;1;34710;6595;41305
FAC0038411;2015-06-25;CLI00568;FACTURA;28;1;103086;19586;122672
FAC0038412;2015-03-01;CLI00332;FACTURA;32;1;302373;57451;359824
FAC0038413;2015-08-08;CLI00947;FACTURA;47;2;170073;32314;202387
FAC0038414;2015-10-08;CLI00479;FACTURA;20;2;243628;46289;289917
FAC0038415;2015-12-26;CLI00906;FACTURA;6;1;25344;4815;30159
FAC0038416;2015-01-24;CLI00079;FACTURA;43;2;348040;66128;414168
FAC0038417;2015-05-08;CLI00323;FACTURA;19;2;117036;22237;139273
FAC0038418;2015-09-14;CLI00785;FACTURA;28;2;170935;32478;203413
FAC0038419;2015-06-03;CLI00561;FACTURA;11;2;68370;12990;81360
FAC0038420;2015-06-26;CLI00001;FACTURA;26;2;108284;20574;128858
FAC0038421;2015-07-07;CLI00265;FACTURA;32;2;52395;9955;62350
FAC0038422;2015-06-04;CLI00904;FACTURA;29;1;122058;23191;145249
FAC0038423;2015-04-09;CLI00388;FACTURA;10;1;6170;1172;7342
FAC0038424;2015-07-19;CLI00166;FACTURA;3;1;64544;12263;76807
FAC0038425;2015-04-26;CLI00612;FACTURA;3;1;47230;8974;56204
FAC0038426;2015-02-21;CLI00611;FACTURA;30;2;49336;9374;58710
FAC0038427;2015-12-06;CLI00072;FACTURA;37;1;25406;4827;30233
FAC0038428;2015-12-28;CLI00579;FACTURA;23;2;28668;5447;34115
FAC0038429;2015-10-24;CLI00379;FACTURA;35;2;138545;26324;164869
FAC0038430;2015-09-05;CLI00275;FACTURA;15;2;145015;27553;172568
FAC0038431;2015-03-10;CLI00262;FACTURA;8;1;128280;24373;152653
FAC0038432;2015-12-19;CLI00770;FACTURA;40;1;158724;30158;188882
FAC0038433;2015-05-12;CLI00228;FACTURA;16;1;70544;13403;83947
FAC0038434;2015-05-06;CLI00174;FACTURA;50;1;226390;43014;269404
FAC0038435;2015-08-25;CLI00747;FACTURA;18;2;49360;9378;58738
FAC0038436;2015-12-07;CLI00651;FACTURA;45;2;75864;14414;90278
FAC0038437;2015-07-21;CLI00881;FACTURA;9;2;277090;52647;329737
FAC0038438;2015-10-02;CLI00984;FACTURA;29;1;104790;19910;124700
FAC0038439;2015-10-07;CLI00545;FACTURA;35;2;111030;21096;132126
FAC0038440;2015-04-11;CLI00139;FACTURA;48;2;76419;14520;90939
FAC0038441;2015-07-18;CLI00672;FACTURA;23;1;348040;66128;414168
FAC0038442;2015-11-18;CLI00252;FACTURA;25;1;186081;35355;221436
FAC0038443;2015-03-15;CLI00737;FACTURA;13;2;35272;6702;41974
FAC0038444;2015-12-15;CLI00703;FACTURA;34;2;48408;9198;57606
FAC0038445;2015-10-03;CLI00567;FACTURA;36;2;126490;24033;150523
FAC0038446;2015-07-28;CLI00036;FACTURA;35;1;34362;6529;40891
FAC0038447;2015-04-15;CLI00503;FACTURA;22;2;75568;14358;89926
FAC0038448;2015-09-15;CLI00211;FACTURA;27;2;56898;10811;67709
FAC0038449;2015-05-04;CLI00245;FACTURA;49;2;147678;28059;175737
FAC0038450;2015-04-22;CLI00303;FACTURA;29;2;71407;13567;84974
FAC0038451;2015-11-04;CLI00772;FACTURA;50;1;39466;7499;46965
FAC0038452;2015-02-15;CLI00112;FACTURA;46;1;123066;23383;146449
FAC0038453;2015-10-24;CLI00467;FACTURA;43;2;98672;18748;117420
FAC0038454;2015-12-28;CLI00300;FACTURA;18;1;58518;11118;69636
FAC0038455;2015-02-19;CLI00054;FACTURA;24;1;16896;3210;20106
FAC0038456;2015-07-10;CLI00371;FACTURA;34;2;163458;31057;194515
FAC0038457;2015-07-20;CLI00089;FACTURA;10;2;37020;7034;44054
FAC0038458;2015-08-11;CLI00537;FACTURA;41;2;83127;15794;98921
FAC0038459;2015-03-25;CLI00828;FACTURA;15;1;159498;30305;189803
FAC0038460;2015-03-29;CLI00632;FACTURA;37;1;58006;11021;69027
FAC0038461;2015-08-24;CLI00924;FACTURA;25;1;196596;37353;233949
FAC0038462;2015-01-04;CLI00316;FACTURA;41;1;170935;32478;203413
FAC0038463;2015-10-26;CLI00987;FACTURA;11;2;61029;11596;72625
FAC0038464;2015-07-13;CLI00544;FACTURA;3;1;76032;14446;90478
FAC0038465;2015-10-22;CLI00371;FACTURA;9;2;246680;46869;293549
FAC0038466;2015-07-18;CLI00427;FACTURA;21;2;48408;9198;57606
FAC0038467;2015-03-25;CLI00622;FACTURA;8;1;201582;38301;239883
FAC0038468;2015-04-26;CLI00402;FACTURA;46;1;252999;48070;301069
FAC0038469;2015-08-01;CLI00107;FACTURA;27;2;254060;48271;302331
FAC0038470;2015-01-04;CLI00659;FACTURA;50;2;87220;16572;103792
FAC0038471;2015-05-05;CLI00514;FACTURA;14;1;132915;25254;158169
FAC0038472;2015-08-26;CLI00088;FACTURA;44;1;135355;25717;161072
FAC0038473;2015-07-18;CLI00406;FACTURA;3;1;61206;11629;72835
FAC0038474;2015-01-05;CLI00048;FACTURA;42;1;50946;9680;60626
FAC0038475;2015-09-26;CLI00853;FACTURA;45;2;132915;25254;158169
FAC0038476;2015-03-28;CLI00224;FACTURA;44;1;127030;24136;151166
FAC0038477;2015-02-26;CLI00093;FACTURA;12;2;196731;37379;234110
FAC0038478;2015-08-31;CLI00591;FACTURA;8;2;55622;10568;66190
FAC0038479;2015-07-02;CLI00709;FACTURA;42;2;166254;31588;197842
FAC0038480;2015-06-15;CLI00375;FACTURA;8;2;347100;65949;413049
FAC0038481;2015-01-07;CLI00201;FACTURA;26;2;128280;24373;152653
FAC0038482;2015-03-11;CLI00401;FACTURA;39;2;126490;24033;150523
FAC0038483;2015-05-03;CLI00508;FACTURA;26;1;246130;46765;292895
FAC0038484;2015-09-30;CLI00908;FACTURA;21;1;48408;9198;57606
FAC0038485;2015-05-06;CLI00523;FACTURA;40;2;113382;21543;134925
FAC0038486;2015-12-16;CLI00226;FACTURA;3;1;112444;21364;133808
FAC0038487;2015-08-29;CLI00414;FACTURA;3;1;42234;8024;50258
FAC0038488;2015-01-12;CLI00007;FACTURA;16;2;98298;18677;116975
FAC0038489;2015-01-21;CLI00754;FACTURA;11;1;95336;18114;113450
FAC0038490;2015-12-09;CLI00411;FACTURA;40;2;56222;10682;66904
FAC0038491;2015-03-31;CLI00859;FACTURA;4;2;246130;46765;292895
FAC0038492;2015-02-20;CLI00284;FACTURA;33;1;158473;30110;188583
FAC0038493;2015-07-03;CLI00302;FACTURA;33;1;229362;43579;272941
FAC0038494;2015-05-18;CLI00515;FACTURA;26;2;24668;4687;29355
FAC0038495;2015-06-24;CLI00430;FACTURA;4;1;235179;44684;279863
FAC0038496;2015-08-21;CLI00662;FACTURA;4;1;56380;10712;67092
FAC0038497;2015-10-05;CLI00825;FACTURA;32;2;109392;20784;130176
FAC0038498;2015-01-07;CLI00497;FACTURA;14;2;60876;11566;72442
FAC0038499;2015-04-09;CLI00592;FACTURA;35;1;123065;23382;146447
FAC0038500;2015-08-04;CLI00090;FACTURA;26;1;246680;46869;293549
FAC0038501;2015-11-05;CLI00385;FACTURA;32;2;141088;26807;167895
FAC0038502;2015-10-24;CLI00535;FACTURA;44;2;281110;53411;334521
FAC0038503;2015-05-31;CLI00194;FACTURA;15;1;56222;10682;66904
FAC0038504;2015-03-12;CLI00896;FACTURA;35;1;68370;12990;81360
FAC0038505;2015-10-17;CLI00129;FACTURA;49;2;107050;20340;127390
FAC0038506;2015-05-30;CLI00626;FACTURA;45;1;136215;25881;162096
FAC0038507;2015-05-02;CLI00754;FACTURA;37;1;168776;32067;200843
FAC0038508;2015-12-25;CLI00797;FACTURA;19;2;127030;24136;151166
FAC0038509;2015-01-07;CLI00432;FACTURA;42;1;195060;37061;232121
FAC0038510;2015-07-26;CLI00667;FACTURA;2;2;61206;11629;72835
FAC0038511;2015-05-04;CLI00967;FACTURA;40;2;168666;32047;200713
FAC0038512;2015-04-12;CLI00478;FACTURA;28;1;167985;31917;199902
FAC0038513;2015-12-29;CLI00732;FACTURA;25;1;37794;7181;44975
FAC0038514;2015-06-16;CLI00919;FACTURA;15;2;7946;1510;9456
FAC0038515;2015-05-01;CLI00750;FACTURA;31;1;143340;27235;170575
FAC0038516;2015-07-26;CLI00348;FACTURA;41;1;47668;9057;56725
FAC0038517;2015-07-22;CLI00820;FACTURA;49;1;181323;34451;215774
FAC0038518;2015-11-23;CLI00661;FACTURA;49;2;16035;3047;19082
FAC0038519;2015-05-06;CLI00284;FACTURA;31;1;100338;19064;119402
FAC0038520;2015-07-23;CLI00128;FACTURA;11;1;43610;8286;51896
FAC0038521;2015-07-26;CLI00764;FACTURA;25;1;50730;9639;60369
FAC0038522;2015-09-11;CLI00488;FACTURA;20;1;135376;25721;161097
FAC0038523;2015-06-02;CLI00654;FACTURA;39;1;229362;43579;272941
FAC0038524;2015-03-08;CLI00654;FACTURA;49;1;168776;32067;200843
FAC0038525;2015-03-27;CLI00155;FACTURA;30;2;171280;32543;203823
FAC0038526;2015-05-20;CLI00132;FACTURA;27;1;152298;28937;181235
FAC0038527;2015-04-22;CLI00858;FACTURA;30;1;242970;46164;289134
FAC0038528;2015-02-26;CLI00299;FACTURA;36;2;31437;5973;37410
FAC0038529;2015-05-12;CLI00043;FACTURA;7;2;147678;28059;175737
FAC0038530;2015-01-30;CLI00361;FACTURA;41;2;75894;14420;90314
FAC0038531;2015-10-21;CLI00411;FACTURA;34;2;22552;4285;26837
FAC0038532;2015-02-20;CLI00245;FACTURA;41;2;138545;26324;164869
FAC0038533;2015-03-19;CLI00098;FACTURA;38;1;138840;26380;165220
FAC0038534;2015-02-25;CLI00024;FACTURA;44;1;35272;6702;41974
FAC0038535;2015-02-03;CLI00636;FACTURA;7;1;80680;15329;96009
FAC0038536;2015-08-17;CLI00906;FACTURA;44;1;136542;25943;162485
FAC0038537;2015-11-30;CLI00331;FACTURA;50;2;6179;1174;7353
FAC0038538;2015-08-12;CLI00272;FACTURA;48;1;74004;14061;88065
FAC0038539;2015-01-02;CLI00215;FACTURA;5;2;277680;52759;330439
FAC0038540;2015-01-30;CLI00434;FACTURA;19;1;172676;32808;205484
FAC0038541;2015-01-13;CLI00016;FACTURA;40;1;28449;5405;33854
FAC0038542;2015-12-08;CLI00443;FACTURA;11;2;173550;32975;206525
FAC0038543;2015-09-08;CLI00531;FACTURA;3;2;182984;34767;217751
FAC0038544;2015-03-28;CLI00321;FACTURA;30;2;228730;43459;272189
FAC0038545;2015-01-13;CLI00797;FACTURA;4;2;43190;8206;51396
FAC0038546;2015-05-06;CLI00683;FACTURA;50;2;196904;37412;234316
FAC0038547;2015-05-14;CLI00835;FACTURA;30;2;83419;15850;99269
FAC0038548;2015-03-22;CLI00395;FACTURA;31;2;76419;14520;90939
FAC0038549;2015-01-16;CLI00071;FACTURA;2;2;66618;12657;79275
FAC0038550;2015-12-08;CLI00382;FACTURA;42;1;27709;5265;32974
FAC0038551;2015-02-26;CLI00780;FACTURA;8;1;90556;17206;107762
FAC0038552;2015-01-13;CLI00056;FACTURA;41;1;136740;25981;162721
FAC0038553;2015-11-10;CLI00881;FACTURA;19;2;22908;4353;27261
FAC0038554;2015-06-21;CLI00608;FACTURA;15;1;52395;9955;62350
FAC0038555;2015-03-17;CLI00016;FACTURA;49;1;60441;11484;71925
FAC0038556;2015-11-09;CLI00081;FACTURA;24;2;221517;42088;263605
FAC0038557;2015-04-22;CLI00921;FACTURA;5;2;85524;16250;101774
FAC0038558;2015-11-18;CLI00850;FACTURA;15;1;54486;10352;64838
FAC0038559;2015-08-07;CLI00643;FACTURA;49;2;162426;30861;193287
FAC0038560;2015-07-28;CLI00271;FACTURA;36;2;68724;13058;81782
FAC0038561;2015-08-27;CLI00719;FACTURA;20;2;94485;17952;112437
FAC0038562;2015-03-02;CLI00853;FACTURA;35;2;181112;34411;215523
FAC0038563;2015-09-26;CLI00775;FACTURA;19;2;47415;9009;56424
FAC0038564;2015-05-03;CLI00017;FACTURA;17;2;80588;15312;95900
FAC0038565;2015-01-25;CLI00856;FACTURA;2;1;55611;10566;66177
FAC0038566;2015-01-14;CLI00514;FACTURA;31;1;37074;7044;44118
FAC0038567;2015-06-05;CLI00376;FACTURA;48;1;211170;40122;251292
FAC0038568;2015-07-22;CLI00732;FACTURA;41;1;22873;4346;27219
FAC0038569;2015-11-24;CLI00079;FACTURA;39;2;113195;21507;134702
FAC0038570;2015-10-08;CLI00623;FACTURA;33;2;37932;7207;45139
FAC0038571;2015-11-18;CLI00042;FACTURA;41;1;54696;10392;65088
FAC0038572;2015-07-10;CLI00540;FACTURA;28;1;20958;3982;24940
FAC0038573;2015-10-17;CLI00991;FACTURA;36;2;32070;6093;38163
FAC0038574;2015-02-03;CLI00757;FACTURA;4;2;28668;5447;34115
FAC0038575;2015-11-22;CLI00839;FACTURA;37;2;24716;4696;29412
FAC0038576;2015-06-15;CLI00077;FACTURA;40;2;55622;10568;66190
FAC0038577;2015-12-24;CLI00340;FACTURA;10;1;160111;30421;190532
FAC0038578;2015-10-22;CLI00555;FACTURA;6;2;25298;4807;30105
FAC0038579;2015-09-07;CLI00707;FACTURA;5;2;101192;19226;120418
FAC0038580;2015-05-29;CLI00669;FACTURA;22;2;128280;24373;152653
FAC0038581;2015-05-19;CLI00910;FACTURA;10;1;65415;12429;77844
FAC0038582;2015-07-11;CLI00373;FACTURA;26;2;18510;3517;22027
FAC0038583;2015-09-24;CLI00672;FACTURA;10;1;177842;33790;211632
FAC0038584;2015-12-29;CLI00033;FACTURA;7;2;172291;32735;205026
FAC0038585;2015-12-15;CLI00268;FACTURA;25;1;76419;14520;90939
FAC0038586;2015-06-28;CLI00632;FACTURA;37;1;6170;1172;7342
FAC0038587;2015-09-29;CLI00145;FACTURA;4;2;277090;52647;329737
FAC0038588;2015-02-27;CLI00196;FACTURA;36;1;105485;20042;125527
FAC0038589;2015-01-25;CLI00656;FACTURA;25;1;98672;18748;117420
FAC0038590;2015-08-28;CLI00635;FACTURA;50;2;87009;16532;103541
FAC0038591;2015-03-31;CLI00238;FACTURA;22;1;16896;3210;20106
FAC0038592;2015-07-11;CLI00724;FACTURA;30;1;186081;35355;221436
FAC0038593;2015-02-27;CLI00668;FACTURA;32;1;76032;14446;90478
FAC0038594;2015-11-08;CLI00457;FACTURA;10;2;137238;26075;163313
FAC0038595;2015-07-31;CLI00173;FACTURA;32;2;168776;32067;200843
FAC0038596;2015-11-26;CLI00989;FACTURA;37;2;68619;13038;81657
FAC0038597;2015-10-17;CLI00103;FACTURA;5;2;122058;23191;145249
FAC0038598;2015-06-18;CLI00680;FACTURA;12;1;14334;2723;17057
FAC0038599;2015-06-24;CLI00492;FACTURA;37;1;277680;52759;330439
FAC0038600;2015-03-29;CLI00822;FACTURA;8;1;40584;7711;48295
FAC0038601;2015-04-22;CLI00467;FACTURA;28;2;33844;6430;40274
FAC0038602;2015-01-30;CLI00147;FACTURA;13;2;136748;25982;162730
FAC0038603;2015-02-07;CLI00191;FACTURA;8;2;37074;7044;44118
FAC0038604;2015-12-17;CLI00617;FACTURA;33;2;101532;19291;120823
FAC0038605;2015-05-09;CLI00021;FACTURA;39;2;96210;18280;114490
FAC0038606;2015-09-23;CLI00136;FACTURA;41;1;210970;40084;251054
FAC0038607;2015-01-22;CLI00190;FACTURA;41;1;205122;38973;244095
FAC0038608;2015-09-04;CLI00373;FACTURA;24;2;21410;4068;25478
FAC0038609;2015-10-14;CLI00320;FACTURA;22;1;91809;17444;109253
FAC0038610;2015-02-28;CLI00404;FACTURA;32;1;78024;14825;92849
FAC0038611;2015-02-06;CLI00261;FACTURA;18;2;68724;13058;81782
FAC0038612;2015-01-25;CLI00795;FACTURA;17;2;307683;58460;366143
FAC0038613;2015-03-09;CLI00303;FACTURA;6;2;196904;37412;234316
FAC0038614;2015-03-14;CLI00345;FACTURA;36;2;16922;3215;20137
FAC0038615;2015-10-19;CLI00864;FACTURA;45;1;55611;10566;66177
FAC0038616;2015-10-31;CLI00590;FACTURA;32;1;84333;16023;100356
FAC0038617;2015-08-12;CLI00004;FACTURA;4;1;18897;3590;22487
FAC0038618;2015-04-28;CLI00432;FACTURA;9;1;307683;58460;366143
FAC0038619;2015-11-09;CLI00180;FACTURA;42;1;66381;12612;78993
FAC0038620;2015-01-03;CLI00232;FACTURA;28;1;18510;3517;22027
FAC0038621;2015-12-14;CLI00447;FACTURA;18;2;39012;7412;46424
FAC0038622;2015-10-16;CLI00265;FACTURA;43;2;75894;14420;90314
FAC0038623;2015-09-24;CLI00397;FACTURA;48;2;87436;16613;104049
FAC0038624;2015-05-12;CLI00408;FACTURA;30;1;75864;14414;90278
FAC0038625;2015-11-21;CLI00560;FACTURA;9;1;9483;1802;11285
FAC0038626;2015-04-05;CLI00085;FACTURA;28;2;32766;6226;38992
FAC0038627;2015-07-31;CLI00665;FACTURA;3;2;85347;16216;101563
FAC0038628;2015-12-04;CLI00154;FACTURA;7;1;201470;38279;239749
FAC0038629;2015-10-04;CLI00583;FACTURA;50;2;54142;10287;64429
FAC0038630;2015-03-29;CLI00214;FACTURA;42;1;33597;6383;39980
FAC0038631;2015-05-12;CLI00971;FACTURA;27;2;49336;9374;58710
FAC0038632;2015-03-13;CLI00248;FACTURA;42;1;168936;32098;201034
FAC0038633;2015-09-17;CLI00884;FACTURA;31;1;101624;19309;120933
FAC0038634;2015-07-05;CLI00213;FACTURA;35;2;126582;24051;150633
FAC0038635;2015-01-20;CLI00189;FACTURA;38;2;48105;9140;57245
FAC0038636;2015-08-18;CLI00601;FACTURA;19;2;47230;8974;56204
FAC0038637;2015-12-17;CLI00585;FACTURA;46;2;28508;5417;33925
FAC0038638;2015-01-29;CLI00983;FACTURA;10;2;50688;9631;60319
FAC0038639;2015-12-24;CLI00416;FACTURA;16;1;43718;8306;52024
FAC0038640;2015-12-29;CLI00090;FACTURA;23;1;141029;26796;167825
FAC0038641;2015-09-27;CLI00419;FACTURA;5;2;202384;38453;240837
FAC0038642;2015-04-13;CLI00109;FACTURA;21;2;7946;1510;9456
FAC0038643;2015-04-02;CLI00802;FACTURA;1;1;229257;43559;272816
FAC0038644;2015-11-15;CLI00273;FACTURA;43;2;30438;5783;36221
FAC0038645;2015-03-25;CLI00439;FACTURA;27;2;25344;4815;30159
FAC0038646;2015-03-21;CLI00843;FACTURA;34;2;25406;4827;30233
FAC0038647;2015-01-08;CLI00350;FACTURA;20;1;140555;26705;167260
FAC0038648;2015-03-30;CLI00529;FACTURA;28;2;84388;16034;100422
FAC0038649;2015-11-23;CLI00901;FACTURA;21;2;21097;4008;25105
FAC0038650;2015-12-05;CLI00375;FACTURA;22;2;11276;2142;13418
FAC0038651;2015-10-11;CLI00270;FACTURA;9;1;132915;25254;158169
FAC0038652;2015-09-08;CLI00092;FACTURA;42;1;272430;51762;324192
FAC0038653;2015-06-16;CLI00749;FACTURA;5;2;152838;29039;181877
FAC0038654;2015-11-09;CLI00708;FACTURA;49;1;64544;12263;76807
FAC0038655;2015-10-07;CLI00825;FACTURA;22;2;262128;49804;311932
FAC0038656;2015-04-20;CLI00006;FACTURA;31;1;47415;9009;56424
FAC0038657;2015-04-22;CLI00400;FACTURA;33;1;117036;22237;139273
FAC0038658;2015-12-04;CLI00059;FACTURA;9;2;50688;9631;60319
FAC0038659;2015-12-24;CLI00856;FACTURA;36;1;49336;9374;58710
FAC0038660;2015-06-15;CLI00045;FACTURA;39;2;172291;32735;205026
FAC0038661;2015-08-22;CLI00821;FACTURA;41;2;91809;17444;109253
FAC0038662;2015-02-12;CLI00151;FACTURA;30;2;43002;8170;51172
FAC0038663;2015-12-10;CLI00047;FACTURA;50;2;68619;13038;81657
FAC0038664;2015-10-16;CLI00011;FACTURA;31;2;35272;6702;41974
FAC0038665;2015-05-25;CLI00707;FACTURA;18;2;21117;4012;25129
FAC0038666;2015-12-01;CLI00242;FACTURA;46;1;94311;17919;112230
FAC0038667;2015-04-21;CLI00412;FACTURA;50;1;242970;46164;289134
FAC0038668;2015-03-17;CLI00857;FACTURA;29;2;34187;6496;40683
FAC0038669;2015-03-01;CLI00175;FACTURA;25;2;278432;52902;331334
FAC0038670;2015-07-10;CLI00715;FACTURA;43;2;190701;36233;226934
FAC0038671;2015-11-13;CLI00344;FACTURA;49;1;101892;19359;121251
FAC0038672;2015-07-07;CLI00303;FACTURA;43;2;210970;40084;251054
FAC0038673;2015-12-14;CLI00676;FACTURA;26;1;106332;20203;126535
FAC0038674;2015-03-11;CLI00988;FACTURA;22;1;71514;13588;85102
FAC0038675;2015-03-10;CLI00098;FACTURA;46;1;10201;1938;12139
FAC0038676;2015-03-20;CLI00554;FACTURA;31;1;91632;17410;109042
FAC0038677;2015-08-08;CLI00095;FACTURA;29;2;27348;5196;32544
FAC0038678;2015-06-11;CLI00327;FACTURA;16;2;37020;7034;44054
FAC0038679;2015-03-10;CLI00276;FACTURA;40;1;54696;10392;65088
FAC0038680;2015-12-13;CLI00694;FACTURA;10;1;59585;11321;70906
FAC0038681;2015-06-26;CLI00257;FACTURA;42;2;71514;13588;85102
FAC0038682;2015-08-01;CLI00658;FACTURA;39;1;15892;3019;18911
FAC0038683;2015-11-18;CLI00268;FACTURA;9;1;91314;17350;108664
FAC0038684;2015-09-01;CLI00419;FACTURA;40;2;81608;15506;97114
FAC0038685;2015-05-15;CLI00051;FACTURA;45;2;114365;21729;136094
FAC0038686;2015-08-23;CLI00716;FACTURA;25;1;195060;37061;232121
FAC0038687;2015-10-20;CLI00700;FACTURA;20;1;171280;32543;203823
FAC0038688;2015-06-04;CLI00049;FACTURA;21;2;163830;31128;194958
FAC0038689;2015-04-25;CLI00035;FACTURA;31;2;178311;33879;212190
FAC0038690;2015-09-07;CLI00524;FACTURA;5;1;6170;1172;7342
FAC0038691;2015-02-23;CLI00774;FACTURA;21;1;22908;4353;27261
FAC0038692;2015-11-20;CLI00798;FACTURA;5;1;177648;33753;211401
FAC0038693;2015-03-29;CLI00982;FACTURA;40;1;6170;1172;7342
FAC0038694;2015-05-29;CLI00195;FACTURA;6;2;84610;16076;100686
FAC0038695;2015-10-30;CLI00449;FACTURA;11;2;256572;48749;305321
FAC0038696;2015-12-17;CLI00087;FACTURA;36;2;59136;11236;70372
FAC0038697;2015-08-19;CLI00735;FACTURA;1;2;23834;4528;28362
FAC0038698;2015-09-27;CLI00658;FACTURA;30;1;11454;2176;13630
FAC0038699;2015-11-05;CLI00199;FACTURA;40;2;170073;32314;202387
FAC0038700;2015-09-23;CLI00131;FACTURA;4;2;105485;20042;125527
FAC0038701;2015-11-13;CLI00607;FACTURA;1;2;307683;58460;366143
FAC0038702;2015-02-13;CLI00387;FACTURA;35;2;133236;25315;158551
FAC0038703;2015-01-25;CLI00010;FACTURA;42;1;221672;42118;263790
FAC0038704;2015-08-10;CLI00798;FACTURA;23;1;196245;37287;233532
FAC0038705;2015-01-25;CLI00381;FACTURA;49;2;140555;26705;167260
FAC0038706;2015-06-17;CLI00797;FACTURA;29;2;128280;24373;152653
FAC0038707;2015-05-05;CLI00961;FACTURA;7;2;216568;41148;257716
FAC0038708;2015-12-16;CLI00938;FACTURA;43;1;37074;7044;44118
FAC0038709;2015-12-10;CLI00542;FACTURA;4;1;43190;8206;51396
FAC0038710;2015-01-22;CLI00776;FACTURA;24;1;94830;18018;112848
FAC0038711;2015-03-24;CLI00267;FACTURA;38;2;112952;21461;134413
FAC0038712;2015-03-11;CLI00847;FACTURA;11;2;91492;17383;108875
FAC0038713;2015-09-29;CLI00845;FACTURA;49;2;140555;26705;167260
FAC0038714;2015-01-30;CLI00089;FACTURA;3;2;75864;14414;90278
FAC0038715;2015-12-02;CLI00768;FACTURA;42;1;100735;19140;119875
FAC0038716;2015-05-14;CLI00972;FACTURA;24;1;50730;9639;60369
FAC0038717;2015-01-24;CLI00788;FACTURA;20;1;28338;5384;33722
FAC0038718;2015-04-21;CLI00460;FACTURA;12;1;126490;24033;150523
FAC0038719;2015-02-23;CLI00011;FACTURA;43;2;24716;4696;29412
FAC0038720;2015-11-05;CLI00871;FACTURA;14;2;131064;24902;155966
FAC0038721;2015-10-14;CLI00420;FACTURA;2;1;9446;1795;11241
FAC0038722;2015-06-25;CLI00423;FACTURA;24;2;312390;59354;371744
FAC0038723;2015-06-28;CLI00775;FACTURA;2;2;285080;54165;339245
FAC0038724;2015-03-15;CLI00790;FACTURA;8;1;312390;59354;371744
FAC0038725;2015-07-15;CLI00998;FACTURA;35;1;62874;11946;74820
FAC0038726;2015-04-02;CLI00783;FACTURA;29;2;44412;8438;52850
FAC0038727;2015-04-01;CLI00749;FACTURA;40;2;127365;24199;151564
FAC0038728;2015-09-21;CLI00090;FACTURA;43;1;37074;7044;44118
FAC0038729;2015-10-02;CLI00999;FACTURA;36;2;71407;13567;84974
FAC0038730;2015-11-09;CLI00456;FACTURA;45;1;143340;27235;170575
FAC0038731;2015-05-14;CLI00935;FACTURA;50;2;83832;15928;99760
FAC0038732;2015-01-06;CLI00343;FACTURA;21;2;313236;59515;372751
FAC0038733;2015-03-28;CLI00476;FACTURA;25;1;285080;54165;339245
FAC0038734;2015-02-22;CLI00892;FACTURA;26;1;98452;18706;117158
FAC0038735;2015-01-05;CLI00034;FACTURA;14;1;167985;31917;199902
FAC0038736;2015-08-12;CLI00684;FACTURA;10;1;105816;20105;125921
FAC0038737;2015-06-13;CLI00291;FACTURA;26;2;16136;3066;19202
FAC0038738;2015-07-09;CLI00674;FACTURA;29;1;40804;7753;48557
FAC0038739;2015-05-09;CLI00018;FACTURA;48;1;20958;3982;24940
FAC0038740;2015-02-20;CLI00518;FACTURA;27;1;168666;32047;200713
FAC0038741;2015-11-03;CLI00322;FACTURA;19;1;142401;27056;169457
FAC0038742;2015-06-30;CLI00855;FACTURA;33;2;50742;9641;60383
FAC0038743;2015-03-16;CLI00533;FACTURA;23;2;67194;12767;79961
FAC0038744;2015-02-06;CLI00734;FACTURA;38;1;141088;26807;167895
FAC0038745;2015-01-06;CLI00526;FACTURA;24;1;16136;3066;19202
FAC0038746;2015-09-05;CLI00449;FACTURA;17;2;227682;43260;270942
FAC0038747;2015-02-25;CLI00226;FACTURA;34;1;100338;19064;119402
FAC0038748;2015-05-05;CLI00523;FACTURA;34;2;16136;3066;19202
FAC0038749;2015-02-15;CLI00210;FACTURA;16;1;71670;13617;85287
FAC0038750;2015-11-24;CLI00746;FACTURA;24;1;10201;1938;12139
FAC0038751;2015-08-07;CLI00438;FACTURA;28;1;28190;5356;33546
FAC0038752;2015-09-08;CLI00103;FACTURA;38;2;208824;39677;248501
FAC0038753;2015-01-17;CLI00869;FACTURA;28;2;168936;32098;201034
FAC0038754;2015-07-18;CLI00167;FACTURA;25;2;307683;58460;366143
FAC0038755;2015-12-01;CLI00130;FACTURA;6;1;91492;17383;108875
FAC0038756;2015-11-05;CLI00207;FACTURA;14;2;41916;7964;49880
FAC0038757;2015-03-04;CLI00135;FACTURA;11;2;228064;43332;271396
FAC0038758;2015-04-17;CLI00871;FACTURA;19;2;37074;7044;44118
FAC0038759;2015-12-30;CLI00919;FACTURA;20;2;75864;14414;90278
FAC0038760;2015-09-13;CLI00344;FACTURA;35;1;227682;43260;270942
FAC0038761;2015-02-19;CLI00451;FACTURA;48;2;151176;28723;179899
FAC0038762;2015-03-30;CLI00328;FACTURA;27;1;57270;10881;68151
FAC0038763;2015-10-25;CLI00300;FACTURA;40;1;69608;13226;82834
FAC0038764;2015-10-22;CLI00867;FACTURA;45;2;61790;11740;73530
FAC0038765;2015-02-15;CLI00667;FACTURA;7;2;95718;18186;113904
FAC0038766;2015-04-23;CLI00826;FACTURA;28;1;105816;20105;125921
FAC0038767;2015-07-14;CLI00257;FACTURA;39;2;270710;51435;322145
FAC0038768;2015-09-04;CLI00918;FACTURA;19;1;31784;6039;37823
FAC0038769;2015-01-29;CLI00761;FACTURA;26;2;192690;36611;229301
FAC0038770;2015-01-07;CLI00020;FACTURA;40;1;203784;38719;242503
FAC0038771;2015-07-15;CLI00482;FACTURA;25;1;25298;4807;30105
FAC0038772;2015-08-15;CLI00107;FACTURA;50;2;123066;23383;146449
FAC0038773;2015-01-26;CLI00728;FACTURA;12;1;66381;12612;78993
FAC0038774;2015-04-22;CLI00619;FACTURA;41;2;33844;6430;40274
FAC0038775;2015-06-09;CLI00112;FACTURA;29;1;55622;10568;66190
FAC0038776;2015-12-24;CLI00386;FACTURA;4;1;239247;45457;284704
FAC0038777;2015-08-08;CLI00108;FACTURA;29;1;252999;48070;301069
FAC0038778;2015-05-30;CLI00088;FACTURA;33;1;95718;18186;113904
FAC0038779;2015-06-27;CLI00152;FACTURA;14;1;94485;17952;112437
FAC0038780;2015-09-12;CLI00821;FACTURA;37;2;120882;22968;143850
FAC0038781;2015-03-15;CLI00783;FACTURA;6;2;232024;44085;276109
FAC0038782;2015-07-22;CLI00033;FACTURA;21;2;54142;10287;64429
FAC0038783;2015-07-28;CLI00402;FACTURA;23;1;67584;12841;80425
FAC0038784;2015-08-19;CLI00356;FACTURA;44;1;11454;2176;13630
FAC0038785;2015-09-12;CLI00342;FACTURA;37;1;23838;4529;28367
FAC0038786;2015-01-04;CLI00203;FACTURA;10;2;290030;55106;345136
FAC0038787;2015-10-23;CLI00032;FACTURA;38;1;114365;21729;136094
FAC0038788;2015-02-06;CLI00814;FACTURA;47;1;87220;16572;103792
FAC0038789;2015-10-09;CLI00777;FACTURA;45;2;196245;37287;233532
FAC0038790;2015-03-20;CLI00211;FACTURA;22;2;221672;42118;263790
FAC0038791;2015-04-03;CLI00607;FACTURA;45;2;196731;37379;234110
FAC0038792;2015-05-12;CLI00047;FACTURA;5;2;17636;3351;20987
FAC0038793;2015-05-21;CLI00445;FACTURA;35;2;70544;13403;83947
FAC0038794;2015-02-23;CLI00480;FACTURA;7;1;50946;9680;60626
FAC0038795;2015-06-13;CLI00246;FACTURA;29;1;232024;44085;276109
FAC0038796;2015-02-14;CLI00740;FACTURA;36;1;173550;32975;206525
FAC0038797;2015-01-18;CLI00025;FACTURA;15;2;221517;42088;263605
FAC0038798;2015-03-29;CLI00551;FACTURA;23;2;42820;8136;50956
FAC0038799;2015-01-22;CLI00868;FACTURA;39;1;239309;45469;284778
FAC0038800;2015-02-14;CLI00198;FACTURA;12;1;152298;28937;181235
FAC0038801;2015-10-23;CLI00304;FACTURA;14;1;25298;4807;30105
FAC0038802;2015-02-25;CLI00686;FACTURA;41;1;78024;14825;92849
FAC0038803;2015-02-16;CLI00005;FACTURA;43;2;84610;16076;100686
FAC0038804;2015-04-27;CLI00414;FACTURA;46;1;8448;1605;10053
FAC0038805;2015-01-16;CLI00394;FACTURA;19;1;40294;7656;47950
FAC0038806;2015-08-12;CLI00375;FACTURA;36;2;163458;31057;194515
FAC0038807;2015-08-15;CLI00872;FACTURA;21;1;43190;8206;51396
FAC0038808;2015-03-23;CLI00091;FACTURA;6;2;221672;42118;263790
FAC0038809;2015-05-14;CLI00408;FACTURA;29;1;32272;6132;38404
FAC0038810;2015-10-31;CLI00756;FACTURA;25;1;246680;46869;293549
FAC0038811;2015-04-18;CLI00347;FACTURA;9;2;142401;27056;169457
FAC0038812;2015-06-02;CLI00531;FACTURA;9;2;32070;6093;38163
FAC0038813;2015-05-20;CLI00882;FACTURA;22;1;55418;10529;65947
FAC0038814;2015-07-30;CLI00487;FACTURA;12;2;9483;1802;11285
FAC0038815;2015-12-25;CLI00652;FACTURA;32;1;22552;4285;26837
FAC0038816;2015-12-16;CLI00773;FACTURA;14;2;7946;1510;9456
FAC0038817;2015-11-10;CLI00718;FACTURA;23;1;45816;8705;54521
FAC0038818;2015-11-07;CLI00289;FACTURA;15;2;135834;25808;161642
FAC0038819;2015-08-05;CLI00417;FACTURA;22;2;205122;38973;244095
FAC0038820;2015-08-20;CLI00993;FACTURA;25;2;312390;59354;371744
FAC0038821;2015-10-12;CLI00698;FACTURA;14;1;12340;2345;14685
FAC0038822;2015-04-12;CLI00538;FACTURA;33;1;192690;36611;229301
FAC0038823;2015-11-10;CLI00983;FACTURA;4;2;196777;37388;234165
FAC0038824;2015-08-06;CLI00796;FACTURA;7;1;42820;8136;50956
FAC0038825;2015-02-18;CLI00279;FACTURA;1;2;95718;18186;113904
FAC0038826;2015-04-26;CLI00355;FACTURA;28;2;50688;9631;60319
FAC0038827;2015-10-13;CLI00063;FACTURA;26;2;16914;3214;20128
FAC0038828;2015-08-04;CLI00700;FACTURA;5;1;45104;8570;53674
FAC0038829;2015-04-04;CLI00633;FACTURA;28;2;21097;4008;25105
FAC0038830;2015-02-06;CLI00974;FACTURA;34;1;30438;5783;36221
FAC0038831;2015-05-30;CLI00157;FACTURA;1;2;168936;32098;201034
FAC0038832;2015-05-01;CLI00223;FACTURA;3;2;161176;30623;191799
FAC0038833;2015-10-08;CLI00128;FACTURA;43;1;81372;15461;96833
FAC0038834;2015-05-18;CLI00342;FACTURA;10;1;94830;18018;112848
FAC0038835;2015-08-07;CLI00023;FACTURA;45;2;203248;38617;241865
FAC0038836;2015-11-14;CLI00605;FACTURA;19;2;202384;38453;240837
FAC0038837;2015-12-17;CLI00161;FACTURA;30;2;54142;10287;64429
FAC0038838;2015-06-13;CLI00892;FACTURA;35;1;43610;8286;51896
FAC0038839;2015-06-17;CLI00910;FACTURA;26;1;199854;37972;237826
FAC0038840;2015-01-20;CLI00630;FACTURA;42;1;181112;34411;215523
FAC0038841;2015-01-10;CLI00658;FACTURA;26;1;171048;32499;203547
FAC0038842;2015-01-18;CLI00610;FACTURA;18;1;79460;15097;94557
FAC0038843;2015-06-01;CLI00749;FACTURA;9;2;177648;33753;211401
FAC0038844;2015-04-03;CLI00230;FACTURA;6;1;52908;10053;62961
FAC0038845;2015-10-02;CLI00498;FACTURA;50;1;126702;24073;150775
FAC0038846;2015-11-17;CLI00866;FACTURA;26;1;246130;46765;292895
FAC0038847;2015-06-12;CLI00209;FACTURA;34;2;222012;42182;264194
FAC0038848;2015-09-10;CLI00627;FACTURA;35;2;114365;21729;136094
FAC0038849;2015-10-27;CLI00097;FACTURA;19;2;30438;5783;36221
FAC0038850;2015-12-22;CLI00095;FACTURA;31;2;243639;46291;289930
FAC0038851;2015-05-06;CLI00957;FACTURA;34;2;15892;3019;18911
FAC0038852;2015-07-26;CLI00083;FACTURA;9;2;145015;27553;172568
FAC0038853;2015-08-27;CLI00477;FACTURA;39;2;53166;10102;63268
FAC0038854;2015-01-21;CLI00463;FACTURA;13;2;96816;18395;115211
FAC0038855;2015-09-20;CLI00944;FACTURA;50;1;61790;11740;73530
FAC0038856;2015-01-09;CLI00664;FACTURA;21;1;98672;18748;117420
FAC0038857;2015-10-02;CLI00958;FACTURA;48;1;123340;23435;146775
FAC0038858;2015-10-21;CLI00218;FACTURA;4;1;174872;33226;208098
FAC0038859;2015-12-17;CLI00618;FACTURA;29;1;34710;6595;41305
FAC0038860;2015-05-10;CLI00758;FACTURA;4;1;63351;12037;75388
FAC0038861;2015-12-13;CLI00602;FACTURA;44;1;50946;9680;60626
FAC0038862;2015-08-06;CLI00653;FACTURA;20;2;67584;12841;80425
FAC0038863;2015-09-17;CLI00753;FACTURA;31;2;76032;14446;90478
FAC0038864;2015-05-29;CLI00976;FACTURA;41;1;69420;13190;82610
FAC0038865;2015-02-21;CLI00792;FACTURA;27;1;35751;6793;42544
FAC0038866;2015-06-09;CLI00531;FACTURA;31;2;24716;4696;29412
FAC0038867;2015-10-15;CLI00976;FACTURA;14;1;52395;9955;62350
FAC0038868;2015-06-22;CLI00661;FACTURA;20;2;174020;33064;207084
FAC0038869;2015-09-01;CLI00660;FACTURA;30;1;50812;9654;60466
FAC0038870;2015-07-02;CLI00691;FACTURA;4;2;128460;24407;152867
FAC0038871;2015-07-08;CLI00551;FACTURA;50;2;136748;25982;162730
FAC0038872;2015-04-19;CLI00419;FACTURA;35;2;49360;9378;58738
FAC0038873;2015-08-27;CLI00790;FACTURA;30;1;94830;18018;112848
FAC0038874;2015-10-23;CLI00695;FACTURA;13;2;249381;47382;296763
FAC0038875;2015-03-08;CLI00688;FACTURA;19;1;90556;17206;107762
FAC0038876;2015-11-24;CLI00312;FACTURA;43;1;212664;40406;253070
FAC0038877;2015-01-07;CLI00791;FACTURA;6;2;281110;53411;334521
FAC0038878;2015-04-25;CLI00752;FACTURA;28;1;5638;1071;6709
FAC0038879;2015-05-01;CLI00655;FACTURA;40;2;37020;7034;44054
FAC0038880;2015-09-28;CLI00074;FACTURA;4;1;50742;9641;60383
FAC0038881;2015-10-15;CLI00938;FACTURA;8;1;218590;41532;260122
FAC0038882;2015-07-18;CLI00946;FACTURA;17;1;188970;35904;224874
FAC0038883;2015-11-27;CLI00197;FACTURA;9;2;71407;13567;84974
FAC0038884;2015-10-21;CLI00341;FACTURA;7;2;341870;64955;406825
FAC0038885;2015-03-12;CLI00669;FACTURA;2;2;87220;16572;103792
FAC0038886;2015-02-07;CLI00310;FACTURA;49;1;51005;9691;60696
FAC0038887;2015-04-29;CLI00944;FACTURA;23;1;232024;44085;276109
FAC0038888;2015-01-16;CLI00561;FACTURA;35;2;141088;26807;167895
FAC0038889;2015-12-04;CLI00125;FACTURA;49;2;151176;28723;179899
FAC0038890;2015-07-23;CLI00413;FACTURA;15;2;176360;33508;209868
FAC0038891;2015-10-05;CLI00009;FACTURA;48;2;163830;31128;194958
FAC0038892;2015-03-26;CLI00012;FACTURA;29;1;60876;11566;72442
FAC0038893;2015-04-27;CLI00067;FACTURA;3;2;28111;5341;33452
FAC0038894;2015-03-04;CLI00616;FACTURA;33;1;162426;30861;193287
FAC0038895;2015-12-28;CLI00124;FACTURA;39;1;55418;10529;65947
FAC0038896;2015-03-08;CLI00662;FACTURA;41;1;25406;4827;30233
FAC0038897;2015-11-17;CLI00110;FACTURA;27;1;45746;8692;54438
FAC0038898;2015-09-29;CLI00166;FACTURA;1;1;138545;26324;164869
FAC0038899;2015-11-11;CLI00454;FACTURA;30;1;107050;20340;127390
FAC0038900;2015-01-31;CLI00214;FACTURA;25;1;40584;7711;48295
FAC0038901;2015-07-25;CLI00115;FACTURA;32;2;114540;21763;136303
FAC0038902;2015-11-22;CLI00058;FACTURA;41;1;88824;16877;105701
FAC0038903;2015-05-21;CLI00437;FACTURA;36;2;174020;33064;207084
FAC0038904;2015-05-12;CLI00625;FACTURA;46;2;56222;10682;66904
FAC0038905;2015-07-21;CLI00324;FACTURA;35;1;85640;16272;101912
FAC0038906;2015-01-25;CLI00259;FACTURA;18;2;87009;16532;103541
FAC0038907;2015-04-18;CLI00329;FACTURA;3;2;196904;37412;234316
FAC0038908;2015-02-05;CLI00366;FACTURA;33;1;252999;48070;301069
FAC0038909;2015-06-16;CLI00015;FACTURA;3;2;148008;28122;176130
FAC0038910;2015-02-25;CLI00857;FACTURA;47;2;40584;7711;48295
FAC0038911;2015-02-01;CLI00492;FACTURA;7;1;20402;3876;24278
FAC0038912;2015-11-22;CLI00404;FACTURA;10;1;65532;12451;77983
FAC0038913;2015-12-31;CLI00883;FACTURA;7;2;23838;4529;28367
FAC0038914;2015-12-02;CLI00455;FACTURA;4;2;34710;6595;41305
FAC0038915;2015-10-19;CLI00316;FACTURA;13;1;37784;7179;44963
FAC0038916;2015-12-09;CLI00643;FACTURA;41;2;98672;18748;117420
FAC0038917;2015-05-26;CLI00612;FACTURA;9;1;221672;42118;263790
FAC0038918;2015-09-09;CLI00381;FACTURA;50;2;123066;23383;146449
FAC0038919;2015-03-31;CLI00717;FACTURA;3;2;174020;33064;207084
FAC0038920;2015-01-05;CLI00328;FACTURA;50;1;151788;28840;180628
FAC0038921;2015-11-07;CLI00212;FACTURA;30;1;76032;14446;90478
FAC0038922;2015-07-28;CLI00594;FACTURA;2;1;100735;19140;119875
FAC0038923;2015-01-27;CLI00313;FACTURA;31;2;83127;15794;98921
FAC0038924;2015-01-27;CLI00371;FACTURA;47;2;123340;23435;146775
FAC0038925;2015-06-29;CLI00043;FACTURA;39;2;35751;6793;42544
FAC0038926;2015-12-30;CLI00569;FACTURA;23;2;312390;59354;371744
FAC0038927;2015-08-11;CLI00987;FACTURA;7;2;227682;43260;270942
FAC0038928;2015-09-27;CLI00184;FACTURA;21;1;252999;48070;301069
FAC0038929;2015-02-25;CLI00274;FACTURA;48;1;136740;25981;162721
FAC0038930;2015-12-01;CLI00752;FACTURA;37;1;10146;1928;12074
FAC0038931;2015-05-23;CLI00919;FACTURA;18;2;217944;41409;259353
FAC0038932;2015-07-21;CLI00077;FACTURA;14;2;47676;9058;56734
FAC0038933;2015-04-30;CLI00999;FACTURA;25;2;216568;41148;257716
FAC0038934;2015-05-15;CLI00651;FACTURA;17;2;135376;25721;161097
FAC0038935;2015-02-02;CLI00264;FACTURA;35;1;228730;43459;272189
FAC0038936;2015-11-29;CLI00125;FACTURA;26;2;136748;25982;162730
FAC0038937;2015-07-26;CLI00483;FACTURA;49;2;7946;1510;9456
FAC0038938;2015-02-28;CLI00646;FACTURA;34;1;71502;13585;85087
FAC0038939;2015-01-27;CLI00525;FACTURA;17;2;32766;6226;38992
FAC0038940;2015-02-20;CLI00740;FACTURA;47;1;22639;4301;26940
FAC0038941;2015-03-31;CLI00634;FACTURA;21;1;71502;13585;85087
FAC0038942;2015-02-05;CLI00280;FACTURA;46;1;22206;4219;26425
FAC0038943;2015-11-29;CLI00522;FACTURA;30;1;126702;24073;150775
FAC0038944;2015-02-16;CLI00575;FACTURA;48;2;90556;17206;107762
FAC0038945;2015-10-18;CLI00605;FACTURA;4;2;64230;12204;76434
FAC0038946;2015-06-10;CLI00341;FACTURA;41;2;106332;20203;126535
FAC0038947;2015-06-21;CLI00107;FACTURA;22;2;81372;15461;96833
FAC0038948;2015-07-15;CLI00592;FACTURA;23;1;80680;15329;96009
FAC0038949;2015-08-12;CLI00980;FACTURA;45;1;256572;48749;305321
FAC0038950;2015-06-26;CLI00330;FACTURA;12;1;246130;46765;292895
FAC0038951;2015-04-28;CLI00695;FACTURA;39;2;66122;12563;78685
FAC0038952;2015-07-12;CLI00920;FACTURA;31;1;174018;33063;207081
FAC0038953;2015-10-25;CLI00333;FACTURA;34;2;155442;29534;184976
FAC0038954;2015-02-05;CLI00439;FACTURA;4;2;50766;9646;60412
FAC0038955;2015-01-30;CLI00677;FACTURA;38;2;127030;24136;151166
FAC0038956;2015-01-07;CLI00546;FACTURA;24;1;61790;11740;73530
FAC0038957;2015-10-27;CLI00155;FACTURA;18;2;217944;41409;259353
FAC0038958;2015-10-13;CLI00007;FACTURA;25;2;37020;7034;44054
FAC0038959;2015-04-29;CLI00225;FACTURA;16;2;83832;15928;99760
FAC0038960;2015-08-18;CLI00855;FACTURA;20;2;272430;51762;324192
FAC0038961;2015-04-24;CLI00716;FACTURA;45;1;108284;20574;128858
FAC0038962;2015-02-07;CLI01000;FACTURA;45;1;252980;48066;301046
FAC0038963;2015-09-19;CLI00018;FACTURA;8;1;158473;30110;188583
FAC0038964;2015-06-25;CLI00717;FACTURA;46;2;131154;24919;156073
FAC0038965;2015-02-06;CLI00548;FACTURA;10;1;175554;33355;208909
FAC0038966;2015-11-14;CLI00625;FACTURA;35;2;67917;12904;80821
FAC0038967;2015-02-20;CLI00791;FACTURA;25;2;128280;24373;152653
FAC0038968;2015-11-15;CLI00541;FACTURA;47;2;182984;34767;217751
FAC0038969;2015-10-28;CLI00824;FACTURA;24;1;45104;8570;53674
FAC0038970;2015-06-25;CLI00996;FACTURA;18;1;246130;46765;292895
FAC0038971;2015-11-09;CLI00256;FACTURA;40;1;51005;9691;60696
FAC0038972;2015-04-29;CLI00360;FACTURA;14;1;211170;40122;251292
FAC0038973;2015-10-29;CLI00143;FACTURA;11;2;224888;42729;267617
FAC0038974;2015-11-05;CLI00363;FACTURA;37;2;347100;65949;413049
FAC0038975;2015-04-06;CLI00252;FACTURA;29;1;147678;28059;175737
FAC0038976;2015-08-31;CLI00661;FACTURA;25;2;101624;19309;120933
FAC0038977;2015-10-14;CLI00976;FACTURA;32;1;101460;19277;120737
FAC0038978;2015-06-04;CLI00077;FACTURA;21;2;221672;42118;263790
FAC0038979;2015-03-15;CLI00958;FACTURA;6;1;8448;1605;10053
FAC0038980;2015-04-10;CLI00324;FACTURA;10;1;108284;20574;128858
FAC0038981;2015-04-03;CLI00441;FACTURA;42;2;249381;47382;296763
FAC0038982;2015-08-11;CLI00957;FACTURA;21;2;16136;3066;19202
FAC0038983;2015-12-19;CLI00341;FACTURA;35;2;32766;6226;38992
FAC0038984;2015-03-22;CLI00505;FACTURA;20;2;63351;12037;75388
FAC0038985;2015-06-25;CLI00068;FACTURA;10;1;74004;14061;88065
FAC0038986;2015-10-29;CLI00005;FACTURA;27;2;23834;4528;28362
FAC0038987;2015-12-29;CLI00314;FACTURA;9;1;24716;4696;29412
FAC0038988;2015-12-26;CLI00240;FACTURA;12;1;14334;2723;17057
FAC0038989;2015-12-16;CLI00646;FACTURA;20;1;168936;32098;201034
FAC0038990;2015-07-22;CLI00425;FACTURA;40;2;177086;33646;210732
FAC0038991;2015-02-28;CLI00384;FACTURA;15;1;28449;5405;33854
FAC0038992;2015-09-17;CLI00296;FACTURA;47;1;94311;17919;112230
FAC0038993;2015-08-16;CLI00714;FACTURA;27;1;203751;38713;242464
FAC0038994;2015-05-21;CLI00664;FACTURA;27;1;28668;5447;34115
FAC0038995;2015-08-19;CLI00457;FACTURA;25;2;229362;43579;272941
FAC0038996;2015-11-13;CLI00340;FACTURA;49;1;214100;40679;254779
FAC0038997;2015-11-30;CLI00165;FACTURA;49;2;54696;10392;65088
FAC0038998;2015-03-30;CLI00623;FACTURA;49;2;61206;11629;72835
FAC0038999;2015-05-28;CLI00518;FACTURA;22;1;55530;10551;66081
FAC0039000;2015-09-28;CLI00343;FACTURA;39;2;163830;31128;194958
FAC0039001;2015-02-17;CLI00547;FACTURA;12;2;176360;33508;209868
FAC0039002;2015-06-24;CLI00552;FACTURA;39;1;71670;13617;85287
FAC0039003;2015-02-12;CLI00189;FACTURA;16;2;54696;10392;65088
FAC0039004;2015-11-25;CLI00949;FACTURA;4;2;158724;30158;188882
FAC0039005;2015-06-25;CLI00280;FACTURA;21;1;214100;40679;254779
FAC0039006;2015-04-26;CLI00826;FACTURA;44;1;175554;33355;208909
FAC0039007;2015-03-03;CLI00189;FACTURA;32;2;138545;26324;164869
FAC0039008;2015-06-29;CLI00922;FACTURA;44;1;5638;1071;6709
FAC0039009;2015-05-08;CLI00073;FACTURA;22;2;168776;32067;200843
FAC0039010;2015-12-17;CLI00511;FACTURA;42;2;222060;42191;264251
FAC0039011;2015-05-24;CLI00313;FACTURA;18;2;188970;35904;224874
FAC0039012;2015-01-07;CLI00557;FACTURA;48;2;20958;3982;24940
FAC0039013;2015-01-09;CLI00565;FACTURA;25;2;30895;5870;36765
FAC0039014;2015-02-16;CLI00759;FACTURA;31;2;63291;12025;75316
FAC0039015;2015-09-06;CLI00946;FACTURA;25;1;30895;5870;36765
FAC0039016;2015-07-12;CLI00813;FACTURA;11;2;42820;8136;50956
FAC0039017;2015-10-15;CLI00517;FACTURA;25;2;123340;23435;146775
FAC0039018;2015-02-27;CLI00694;FACTURA;16;1;23838;4529;28367
FAC0039019;2015-01-31;CLI00113;FACTURA;43;2;50946;9680;60626
FAC0039020;2015-07-15;CLI00241;FACTURA;32;2;168776;32067;200843
FAC0039021;2015-07-11;CLI00657;FACTURA;34;2;136542;25943;162485
FAC0039022;2015-03-24;CLI00158;FACTURA;30;1;12340;2345;14685
FAC0039023;2015-07-08;CLI00863;FACTURA;4;2;21859;4153;26012
FAC0039024;2015-11-04;CLI00710;FACTURA;29;1;87220;16572;103792
FAC0039025;2015-04-04;CLI00935;FACTURA;25;2;33828;6427;40255
FAC0039026;2015-03-31;CLI00251;FACTURA;5;2;11917;2264;14181
FAC0039027;2015-02-14;CLI00848;FACTURA;19;1;32070;6093;38163
FAC0039028;2015-10-12;CLI00344;FACTURA;8;1;69608;13226;82834
FAC0039029;2015-07-24;CLI00540;FACTURA;6;1;101715;19326;121041
FAC0039030;2015-10-02;CLI00610;FACTURA;20;1;242970;46164;289134
FAC0039031;2015-09-13;CLI00626;FACTURA;9;1;30603;5815;36418
FAC0039032;2015-08-23;CLI00681;FACTURA;35;2;102010;19382;121392
FAC0039033;2015-12-09;CLI00354;FACTURA;24;1;112952;21461;134413
FAC0039034;2015-07-11;CLI00469;FACTURA;35;2;235179;44684;279863
FAC0039035;2015-06-05;CLI00632;FACTURA;13;1;189497;36004;225501
FAC0039036;2015-04-21;CLI00575;FACTURA;47;2;265830;50508;316338
FAC0039037;2015-04-07;CLI00317;FACTURA;11;2;76032;14446;90478
FAC0039038;2015-03-21;CLI00321;FACTURA;30;2;196245;37287;233532
FAC0039039;2015-03-18;CLI00933;FACTURA;35;2;114032;21666;135698
FAC0039040;2015-07-16;CLI00119;FACTURA;38;2;189497;36004;225501
FAC0039041;2015-03-31;CLI00013;FACTURA;2;2;18537;3522;22059
FAC0039042;2015-05-15;CLI00321;FACTURA;10;2;24668;4687;29355
FAC0039043;2015-05-05;CLI00275;FACTURA;8;2;128280;24373;152653
FAC0039044;2015-09-01;CLI00654;FACTURA;49;1;105485;20042;125527
FAC0039045;2015-12-28;CLI00409;FACTURA;17;2;111030;21096;132126
FAC0039046;2015-12-28;CLI00202;FACTURA;48;1;18892;3589;22481
FAC0039047;2015-08-09;CLI00566;FACTURA;30;1;28668;5447;34115
FAC0039048;2015-08-02;CLI00855;FACTURA;32;2;25298;4807;30105
FAC0039049;2015-11-17;CLI00401;FACTURA;40;2;23838;4529;28367
FAC0039050;2015-01-27;CLI00873;FACTURA;43;2;57016;10833;67849
FAC0039051;2015-10-04;CLI00933;FACTURA;29;2;47415;9009;56424
FAC0039052;2015-04-15;CLI00147;FACTURA;44;2;100735;19140;119875
FAC0039053;2015-02-18;CLI00862;FACTURA;50;1;35272;6702;41974
FAC0039054;2015-07-11;CLI00286;FACTURA;46;1;174018;33063;207081
FAC0039055;2015-12-15;CLI00569;FACTURA;3;2;59585;11321;70906
FAC0039056;2015-02-23;CLI00125;FACTURA;37;2;114365;21729;136094
FAC0039057;2015-04-24;CLI00154;FACTURA;25;1;270710;51435;322145
FAC0039058;2015-01-16;CLI00499;FACTURA;32;2;23838;4529;28367
FAC0039059;2015-07-19;CLI00319;FACTURA;8;2;41916;7964;49880
FAC0039060;2015-03-07;CLI00168;FACTURA;21;1;113195;21507;134702
FAC0039061;2015-11-07;CLI00739;FACTURA;12;2;249381;47382;296763
FAC0039062;2015-07-12;CLI00820;FACTURA;22;1;22206;4219;26425
FAC0039063;2015-07-14;CLI00977;FACTURA;41;2;76032;14446;90478
FAC0039064;2015-02-27;CLI00532;FACTURA;15;1;43610;8286;51896
FAC0039065;2015-04-27;CLI00592;FACTURA;18;1;109295;20766;130061
FAC0039066;2015-05-06;CLI00023;FACTURA;10;2;23834;4528;28362
FAC0039067;2015-07-05;CLI00365;FACTURA;44;2;254730;48399;303129
FAC0039068;2015-09-08;CLI00233;FACTURA;2;2;162744;30921;193665
FAC0039069;2015-03-07;CLI00453;FACTURA;20;2;94830;18018;112848
FAC0039070;2015-06-11;CLI00942;FACTURA;28;1;189873;36076;225949
FAC0039071;2015-04-23;CLI00883;FACTURA;42;2;87009;16532;103541
FAC0039072;2015-12-27;CLI00113;FACTURA;14;2;22908;4353;27261
FAC0039073;2015-07-23;CLI00875;FACTURA;28;2;18966;3604;22570
FAC0039074;2015-08-22;CLI00743;FACTURA;6;2;62874;11946;74820
FAC0039075;2015-05-29;CLI00647;FACTURA;14;2;30850;5862;36712
FAC0039076;2015-01-04;CLI00495;FACTURA;13;2;101532;19291;120823
FAC0039077;2015-03-21;CLI00496;FACTURA;2;1;285080;54165;339245
FAC0039078;2015-12-27;CLI00051;FACTURA;10;2;19506;3706;23212
FAC0039079;2015-07-19;CLI00637;FACTURA;43;2;162744;30921;193665
FAC0039080;2015-06-18;CLI00566;FACTURA;3;1;313236;59515;372751
FAC0039081;2015-09-21;CLI00668;FACTURA;26;1;28111;5341;33452
FAC0039082;2015-06-08;CLI00850;FACTURA;1;1;246130;46765;292895
FAC0039083;2015-12-26;CLI00842;FACTURA;41;1;174440;33144;207584
FAC0039084;2015-12-24;CLI00796;FACTURA;4;1;152298;28937;181235
FAC0039085;2015-05-08;CLI00841;FACTURA;32;2;285080;54165;339245
FAC0039086;2015-05-03;CLI00638;FACTURA;18;1;100735;19140;119875
FAC0039087;2015-04-06;CLI00043;FACTURA;14;2;21117;4012;25129
FAC0039088;2015-12-17;CLI00746;FACTURA;3;1;203248;38617;241865
FAC0039089;2015-07-29;CLI00623;FACTURA;42;2;189873;36076;225949
FAC0039090;2015-06-09;CLI00086;FACTURA;32;1;130830;24858;155688
FAC0039091;2015-05-13;CLI00879;FACTURA;37;2;59136;11236;70372
FAC0039092;2015-01-02;CLI00561;FACTURA;23;2;96816;18395;115211
FAC0039093;2015-02-19;CLI00270;FACTURA;17;1;222060;42191;264251
FAC0039094;2015-01-25;CLI00259;FACTURA;20;2;49336;9374;58710
FAC0039095;2015-03-31;CLI00944;FACTURA;50;1;43610;8286;51896
FAC0039096;2015-01-03;CLI00056;FACTURA;13;1;140555;26705;167260
FAC0039097;2015-09-29;CLI00279;FACTURA;2;2;75864;14414;90278
FAC0039098;2015-06-17;CLI00777;FACTURA;10;2;65532;12451;77983
FAC0039099;2015-10-19;CLI00241;FACTURA;6;2;18966;3604;22570
FAC0039100;2015-08-03;CLI00560;FACTURA;48;1;126582;24051;150633
FAC0039101;2015-10-16;CLI00388;FACTURA;47;1;21117;4012;25129
FAC0039102;2015-05-06;CLI00729;FACTURA;26;2;262128;49804;311932
FAC0039103;2015-11-05;CLI00135;FACTURA;31;2;11276;2142;13418
FAC0039104;2015-12-22;CLI00310;FACTURA;10;1;109392;20784;130176
FAC0039105;2015-03-16;CLI00838;FACTURA;37;1;277090;52647;329737
FAC0039106;2015-11-20;CLI00771;FACTURA;34;2;30895;5870;36765
FAC0039107;2015-10-05;CLI00230;FACTURA;45;1;277680;52759;330439
FAC0039108;2015-04-10;CLI00419;FACTURA;6;2;20147;3828;23975
FAC0039109;2015-05-01;CLI00724;FACTURA;28;1;149870;28475;178345
FAC0039110;2015-05-13;CLI00526;FACTURA;7;1;341870;64955;406825
FAC0039111;2015-06-15;CLI00439;FACTURA;1;2;102010;19382;121392
FAC0039112;2015-09-03;CLI00219;FACTURA;46;2;98298;18677;116975
FAC0039113;2015-04-26;CLI00211;FACTURA;40;2;218590;41532;260122
FAC0039114;2015-01-08;CLI00808;FACTURA;15;1;101532;19291;120823
FAC0039115;2015-03-08;CLI00859;FACTURA;24;2;141029;26796;167825
FAC0039116;2015-01-19;CLI00179;FACTURA;16;2;126490;24033;150523
FAC0039117;2015-09-17;CLI00230;FACTURA;2;1;25406;4827;30233
FAC0039118;2015-07-20;CLI00149;FACTURA;50;2;86004;16341;102345
FAC0039119;2015-07-19;CLI00789;FACTURA;26;2;18966;3604;22570
FAC0039120;2015-05-19;CLI00986;FACTURA;45;1;16896;3210;20106
FAC0039121;2015-02-16;CLI00687;FACTURA;30;2;59136;11236;70372
FAC0039122;2015-08-02;CLI00148;FACTURA;37;1;50766;9646;60412
FAC0039123;2015-10-22;CLI00303;FACTURA;13;2;71502;13585;85087
FAC0039124;2015-02-10;CLI00218;FACTURA;32;1;56898;10811;67709
FAC0039125;2015-11-17;CLI00729;FACTURA;3;2;122058;23191;145249
FAC0039126;2015-07-25;CLI00848;FACTURA;44;1;126702;24073;150775
FAC0039127;2015-07-19;CLI00730;FACTURA;33;1;190701;36233;226934
FAC0039128;2015-01-04;CLI00509;FACTURA;10;2;76419;14520;90939
FAC0039129;2015-07-15;CLI00802;FACTURA;8;1;254730;48399;303129
FAC0039130;2015-09-16;CLI00844;FACTURA;5;1;101532;19291;120823
FAC0039131;2015-09-10;CLI00272;FACTURA;21;1;88180;16754;104934
FAC0039132;2015-02-06;CLI00596;FACTURA;26;1;25298;4807;30105
FAC0039133;2015-06-11;CLI00573;FACTURA;11;2;109025;20715;129740
FAC0039134;2015-04-14;CLI00757;FACTURA;34;2;252999;48070;301069
FAC0039135;2015-10-19;CLI00290;FACTURA;13;1;212664;40406;253070
FAC0039136;2015-12-15;CLI00608;FACTURA;36;1;21859;4153;26012
FAC0039137;2015-04-05;CLI00072;FACTURA;13;1;138840;26380;165220
FAC0039138;2015-02-12;CLI00686;FACTURA;1;1;40584;7711;48295
FAC0039139;2015-09-18;CLI00377;FACTURA;2;2;45816;8705;54521
FAC0039140;2015-04-02;CLI00608;FACTURA;12;1;177086;33646;210732
FAC0039141;2015-01-31;CLI00008;FACTURA;48;1;84388;16034;100422
FAC0039142;2015-09-11;CLI00381;FACTURA;29;2;138545;26324;164869
FAC0039143;2015-10-31;CLI00971;FACTURA;41;2;84468;16049;100517
FAC0039144;2015-02-12;CLI00729;FACTURA;38;2;327660;62255;389915
FAC0039145;2015-03-16;CLI00132;FACTURA;23;1;103086;19586;122672
FAC0039146;2015-03-26;CLI00006;FACTURA;41;1;55611;10566;66177
FAC0039147;2015-08-26;CLI00145;FACTURA;31;2;30438;5783;36221
FAC0039148;2015-07-21;CLI00021;FACTURA;40;2;82044;15588;97632
FAC0039149;2015-01-21;CLI00414;FACTURA;26;1;22552;4285;26837
FAC0039150;2015-12-11;CLI00493;FACTURA;27;2;123065;23382;146447
FAC0039151;2015-04-23;CLI00618;FACTURA;36;1;75894;14420;90314
FAC0039152;2015-08-14;CLI00252;FACTURA;2;1;126582;24051;150633
FAC0039153;2015-05-31;CLI00952;FACTURA;38;1;58006;11021;69027
FAC0039154;2015-04-09;CLI00406;FACTURA;25;1;104790;19910;124700
FAC0039155;2015-09-27;CLI00354;FACTURA;14;1;108972;20705;129677
FAC0039156;2015-06-25;CLI00719;FACTURA;24;2;31784;6039;37823
FAC0039157;2015-04-11;CLI00063;FACTURA;21;2;174020;33064;207084
FAC0039158;2015-04-28;CLI00095;FACTURA;23;2;109295;20766;130061
FAC0039159;2015-12-31;CLI00256;FACTURA;35;1;14334;2723;17057
FAC0039160;2015-09-24;CLI00794;FACTURA;33;1;95336;18114;113450
FAC0039161;2015-05-05;CLI00279;FACTURA;37;2;227682;43260;270942
FAC0039162;2015-02-01;CLI00223;FACTURA;4;2;40804;7753;48557
FAC0039163;2015-06-06;CLI00544;FACTURA;3;1;29003;5511;34514
FAC0039164;2015-11-16;CLI00442;FACTURA;49;1;18892;3589;22481
FAC0039165;2015-02-05;CLI00037;FACTURA;5;2;85640;16272;101912
FAC0039166;2015-08-03;CLI00019;FACTURA;8;2;272430;51762;324192
FAC0039167;2015-01-04;CLI00417;FACTURA;38;2;132279;25133;157412
FAC0039168;2015-04-01;CLI00902;FACTURA;17;1;25473;4840;30313
FAC0039169;2015-12-08;CLI00781;FACTURA;19;2;66381;12612;78993
FAC0039170;2015-09-11;CLI00319;FACTURA;49;2;20292;3855;24147
FAC0039171;2015-11-19;CLI00667;FACTURA;12;2;174872;33226;208098
FAC0039172;2015-10-29;CLI00226;FACTURA;36;1;58518;11118;69636
FAC0039173;2015-07-08;CLI00452;FACTURA;47;1;37020;7034;44054
FAC0039174;2015-03-14;CLI00111;FACTURA;28;2;27071;5143;32214
FAC0039175;2015-05-01;CLI00555;FACTURA;13;2;11454;2176;13630
FAC0039176;2015-12-25;CLI00017;FACTURA;45;2;109025;20715;129740
FAC0039177;2015-06-24;CLI00686;FACTURA;27;1;81608;15506;97114
FAC0039178;2015-06-30;CLI00768;FACTURA;1;1;101460;19277;120737
FAC0039179;2015-03-03;CLI00365;FACTURA;5;2;136748;25982;162730
FAC0039180;2015-08-28;CLI00340;FACTURA;8;1;83127;15794;98921
FAC0039181;2015-04-27;CLI00273;FACTURA;25;2;188970;35904;224874
FAC0039182;2015-12-06;CLI00038;FACTURA;47;1;177086;33646;210732
FAC0039183;2015-03-11;CLI00149;FACTURA;5;2;71407;13567;84974
FAC0039184;2015-12-27;CLI00090;FACTURA;35;1;66122;12563;78685
FAC0039185;2015-01-22;CLI00839;FACTURA;2;2;87220;16572;103792
FAC0039186;2015-08-02;CLI00825;FACTURA;9;2;70544;13403;83947
FAC0039187;2015-05-17;CLI00883;FACTURA;1;2;75588;14362;89950
FAC0039188;2015-05-10;CLI00101;FACTURA;19;2;114032;21666;135698
FAC0039189;2015-12-18;CLI00663;FACTURA;6;2;66381;12612;78993
FAC0039190;2015-09-04;CLI00668;FACTURA;13;1;94311;17919;112230
FAC0039191;2015-01-31;CLI00776;FACTURA;38;1;59585;11321;70906
FAC0039192;2015-10-03;CLI00631;FACTURA;23;2;71407;13567;84974
FAC0039193;2015-05-20;CLI00095;FACTURA;15;2;197344;37495;234839
FAC0039194;2015-06-04;CLI00348;FACTURA;27;1;155442;29534;184976
FAC0039195;2015-09-25;CLI00598;FACTURA;37;1;67917;12904;80821
FAC0039196;2015-02-07;CLI00085;FACTURA;16;2;80175;15233;95408
FAC0039197;2015-07-07;CLI00747;FACTURA;20;2;37020;7034;44054
FAC0039198;2015-10-11;CLI00794;FACTURA;30;1;28668;5447;34115
FAC0039199;2015-12-31;CLI00619;FACTURA;41;2;138545;26324;164869
FAC0039200;2015-05-20;CLI00450;FACTURA;34;1;177842;33790;211632
FAC0039201;2015-12-16;CLI00454;FACTURA;15;1;177842;33790;211632
FAC0039202;2015-09-20;CLI00854;FACTURA;47;1;71022;13494;84516
FAC0039203;2015-02-20;CLI00826;FACTURA;43;1;55530;10551;66081
FAC0039204;2015-01-19;CLI00744;FACTURA;30;1;347100;65949;413049
FAC0039205;2015-09-04;CLI00479;FACTURA;16;2;45746;8692;54438
FAC0039206;2015-08-18;CLI00020;FACTURA;4;1;243628;46289;289917
FAC0039207;2015-03-24;CLI00192;FACTURA;40;1;158473;30110;188583
FAC0039208;2015-05-26;CLI00605;FACTURA;30;2;50742;9641;60383
FAC0039209;2015-09-19;CLI00578;FACTURA;29;1;56898;10811;67709
FAC0039210;2015-07-16;CLI00654;FACTURA;50;1;144315;27420;171735
FAC0039211;2015-06-03;CLI00794;FACTURA;32;1;136748;25982;162730
FAC0039212;2015-04-20;CLI00033;FACTURA;3;2;141029;26796;167825
FAC0039213;2015-10-22;CLI00499;FACTURA;5;2;112245;21327;133572
FAC0039214;2015-11-28;CLI00324;FACTURA;35;1;28449;5405;33854
FAC0039215;2015-04-16;CLI00770;FACTURA;21;1;102010;19382;121392
FAC0039216;2015-06-29;CLI00022;FACTURA;37;1;16922;3215;20137
FAC0039217;2015-07-09;CLI00100;FACTURA;5;1;174872;33226;208098
FAC0039218;2015-11-17;CLI00535;FACTURA;30;2;254060;48271;302331
FAC0039219;2015-02-25;CLI00290;FACTURA;44;1;153013;29072;182085
FAC0039220;2015-01-06;CLI00084;FACTURA;3;1;123066;23383;146449
FAC0039221;2015-10-13;CLI00826;FACTURA;24;1;85014;16153;101167
FAC0039222;2015-07-13;CLI00121;FACTURA;6;2;123340;23435;146775
FAC0039223;2015-10-19;CLI00664;FACTURA;27;1;195060;37061;232121
FAC0039224;2015-12-16;CLI00521;FACTURA;35;2;60876;11566;72442
FAC0039225;2015-11-04;CLI00085;FACTURA;24;2;63568;12078;75646
FAC0039226;2015-11-05;CLI00252;FACTURA;49;1;39466;7499;46965
FAC0039227;2015-05-28;CLI00433;FACTURA;15;2;108284;20574;128858
FAC0039228;2015-07-23;CLI00403;FACTURA;9;2;252999;48070;301069
FAC0039229;2015-05-02;CLI00209;FACTURA;12;2;55622;10568;66190
FAC0039230;2015-09-10;CLI00863;FACTURA;27;2;27709;5265;32974
FAC0039231;2015-12-27;CLI00536;FACTURA;36;1;221517;42088;263605
FAC0039232;2015-07-22;CLI00532;FACTURA;11;1;245187;46586;291773
FAC0039233;2015-11-19;CLI00292;FACTURA;25;1;40294;7656;47950
FAC0039234;2015-04-09;CLI00816;FACTURA;4;1;281110;53411;334521
FAC0039235;2015-02-08;CLI00347;FACTURA;31;2;44412;8438;52850
FAC0039236;2015-05-29;CLI00988;FACTURA;16;1;16922;3215;20137
FAC0039237;2015-06-02;CLI00094;FACTURA;43;1;136740;25981;162721
FAC0039238;2015-12-18;CLI00687;FACTURA;19;2;222060;42191;264251
FAC0039239;2015-01-22;CLI00332;FACTURA;44;1;19506;3706;23212
FAC0039240;2015-12-31;CLI00595;FACTURA;5;2;139216;26451;165667
FAC0039241;2015-08-13;CLI00640;FACTURA;8;1;91632;17410;109042
FAC0039242;2015-11-05;CLI00445;FACTURA;32;2;40294;7656;47950
FAC0039243;2015-08-05;CLI00519;FACTURA;49;2;18966;3604;22570
FAC0039244;2015-05-15;CLI00912;FACTURA;45;1;313236;59515;372751
FAC0039245;2015-11-12;CLI00498;FACTURA;19;1;75588;14362;89950
FAC0039246;2015-12-17;CLI00316;FACTURA;41;1;91809;17444;109253
FAC0039247;2015-09-22;CLI00812;FACTURA;32;1;302373;57451;359824
FAC0039248;2015-12-22;CLI00212;FACTURA;47;1;65532;12451;77983
FAC0039249;2015-06-02;CLI00853;FACTURA;8;2;40686;7730;48416
FAC0039250;2015-03-10;CLI00071;FACTURA;32;2;109392;20784;130176
FAC0039251;2015-10-02;CLI00090;FACTURA;5;1;109295;20766;130061
FAC0039252;2015-06-03;CLI00663;FACTURA;3;2;277090;52647;329737
FAC0039253;2015-11-02;CLI00753;FACTURA;4;2;28668;5447;34115
FAC0039254;2015-10-20;CLI00675;FACTURA;23;2;21410;4068;25478
FAC0039255;2015-05-24;CLI00841;FACTURA;50;2;235179;44684;279863
FAC0039256;2015-05-23;CLI00786;FACTURA;12;1;177842;33790;211632
FAC0039257;2015-01-27;CLI00053;FACTURA;39;2;189497;36004;225501
FAC0039258;2015-11-02;CLI00675;FACTURA;22;2;56380;10712;67092
FAC0039259;2015-04-10;CLI00244;FACTURA;24;1;177842;33790;211632
FAC0039260;2015-02-02;CLI00108;FACTURA;14;1;102010;19382;121392
FAC0039261;2015-02-26;CLI00482;FACTURA;6;1;110836;21059;131895
FAC0039262;2015-01-06;CLI00788;FACTURA;1;1;174020;33064;207084
FAC0039263;2015-01-19;CLI00588;FACTURA;4;1;152436;28963;181399
FAC0039264;2015-04-02;CLI00581;FACTURA;23;2;52908;10053;62961
FAC0039265;2015-10-22;CLI00416;FACTURA;29;1;10146;1928;12074
FAC0039266;2015-07-08;CLI00899;FACTURA;15;2;199854;37972;237826
FAC0039267;2015-02-15;CLI00845;FACTURA;26;2;31784;6039;37823
FAC0039268;2015-10-17;CLI00347;FACTURA;18;2;83127;15794;98921
FAC0039269;2015-04-30;CLI00794;FACTURA;30;1;197344;37495;234839
FAC0039270;2015-11-16;CLI00150;FACTURA;25;1;112952;21461;134413
FAC0039271;2015-12-21;CLI00159;FACTURA;29;2;44412;8438;52850
FAC0039272;2015-04-19;CLI00032;FACTURA;7;1;64544;12263;76807
FAC0039273;2015-02-23;CLI00600;FACTURA;13;1;196596;37353;233949
FAC0039274;2015-06-24;CLI00157;FACTURA;28;2;14334;2723;17057
FAC0039275;2015-08-07;CLI00360;FACTURA;2;1;114672;21788;136460
FAC0039276;2015-10-12;CLI00416;FACTURA;10;1;43190;8206;51396
FAC0039277;2015-04-11;CLI00875;FACTURA;21;2;278432;52902;331334
FAC0039278;2015-01-19;CLI00179;FACTURA;35;2;159498;30305;189803
FAC0039279;2015-10-16;CLI00214;FACTURA;5;1;17636;3351;20987
FAC0039280;2015-05-08;CLI00466;FACTURA;14;1;203784;38719;242503
FAC0039281;2015-06-17;CLI00970;FACTURA;48;1;24668;4687;29355
FAC0039282;2015-02-27;CLI00066;FACTURA;24;1;18510;3517;22027
FAC0039283;2015-05-09;CLI00398;FACTURA;30;1;76218;14481;90699
FAC0039284;2015-07-28;CLI00196;FACTURA;17;1;57336;10894;68230
FAC0039285;2015-12-25;CLI00015;FACTURA;37;2;55611;10566;66177
FAC0039286;2015-09-23;CLI00317;FACTURA;25;2;75894;14420;90314
FAC0039287;2015-07-20;CLI00556;FACTURA;29;1;37074;7044;44118
FAC0039288;2015-08-03;CLI00469;FACTURA;50;2;39730;7549;47279
FAC0039289;2015-11-23;CLI00716;FACTURA;6;1;14334;2723;17057
FAC0039290;2015-11-07;CLI00413;FACTURA;25;2;10479;1991;12470
FAC0039291;2015-01-11;CLI00221;FACTURA;15;2;100791;19150;119941
FAC0039292;2015-11-02;CLI00536;FACTURA;22;1;94460;17947;112407
FAC0039293;2015-01-10;CLI00883;FACTURA;36;2;43190;8206;51396
FAC0039294;2015-11-10;CLI00318;FACTURA;44;1;138545;26324;164869
FAC0039295;2015-04-28;CLI00784;FACTURA;45;1;73839;14029;87868
FAC0039296;2015-02-05;CLI00058;FACTURA;2;1;67917;12904;80821
FAC0039297;2015-12-19;CLI00086;FACTURA;15;1;28190;5356;33546
FAC0039298;2015-05-31;CLI00920;FACTURA;18;1;133236;25315;158551
FAC0039299;2015-01-03;CLI00779;FACTURA;9;2;96816;18395;115211
FAC0039300;2015-03-14;CLI00319;FACTURA;28;2;25298;4807;30105
FAC0039301;2015-12-29;CLI00552;FACTURA;47;1;68619;13038;81657
FAC0039302;2015-02-05;CLI00300;FACTURA;7;1;67194;12767;79961
FAC0039303;2015-03-04;CLI00985;FACTURA;45;2;84480;16051;100531
FAC0039304;2015-12-06;CLI00474;FACTURA;42;1;120882;22968;143850
FAC0039305;2015-10-23;CLI00987;FACTURA;39;2;57270;10881;68151
FAC0039306;2015-08-17;CLI00112;FACTURA;29;1;79749;15152;94901
FAC0039307;2015-12-10;CLI00097;FACTURA;24;2;47415;9009;56424
FAC0039308;2015-06-29;CLI00152;FACTURA;33;1;122058;23191;145249
FAC0039309;2015-03-08;CLI00704;FACTURA;36;1;105585;20061;125646
FAC0039310;2015-03-11;CLI00093;FACTURA;50;2;27071;5143;32214
FAC0039311;2015-06-03;CLI00872;FACTURA;17;1;229257;43559;272816
FAC0039312;2015-06-22;CLI00351;FACTURA;37;2;81608;15506;97114
FAC0039313;2015-06-30;CLI00389;FACTURA;50;2;243628;46289;289917
FAC0039314;2015-03-16;CLI00604;FACTURA;30;1;67688;12861;80549
FAC0039315;2015-12-26;CLI00383;FACTURA;14;2;245187;46586;291773
FAC0039316;2015-05-07;CLI00917;FACTURA;39;2;79749;15152;94901
FAC0039317;2015-01-28;CLI00080;FACTURA;34;1;81608;15506;97114
FAC0039318;2015-07-07;CLI00079;FACTURA;2;2;23834;4528;28362
FAC0039319;2015-10-10;CLI00540;FACTURA;44;1;20292;3855;24147
FAC0039320;2015-09-25;CLI00556;FACTURA;11;1;262128;49804;311932
FAC0039321;2015-01-11;CLI00754;FACTURA;2;1;83127;15794;98921
FAC0039322;2015-02-10;CLI00843;FACTURA;49;2;40294;7656;47950
FAC0039323;2015-01-17;CLI00914;FACTURA;37;1;147679;28059;175738
FAC0039324;2015-12-10;CLI00014;FACTURA;2;1;45816;8705;54521
FAC0039325;2015-03-20;CLI00236;FACTURA;31;1;69420;13190;82610
FAC0039326;2015-07-09;CLI00960;FACTURA;50;1;262128;49804;311932
FAC0039327;2015-11-16;CLI00912;FACTURA;35;1;28338;5384;33722
FAC0039328;2015-07-01;CLI00448;FACTURA;10;1;55611;10566;66177
FAC0039329;2015-05-26;CLI00155;FACTURA;6;2;163830;31128;194958
FAC0039330;2015-07-09;CLI00635;FACTURA;32;2;265830;50508;316338
FAC0039331;2015-07-05;CLI00230;FACTURA;17;1;75864;14414;90278
FAC0039332;2015-04-24;CLI00705;FACTURA;24;2;190053;36110;226163
FAC0039333;2015-06-17;CLI00649;FACTURA;12;2;114672;21788;136460
FAC0039334;2015-01-28;CLI00713;FACTURA;13;2;16136;3066;19202
FAC0039335;2015-12-18;CLI00547;FACTURA;34;2;123066;23383;146449
FAC0039336;2015-08-22;CLI00126;FACTURA;24;1;208824;39677;248501
FAC0039337;2015-06-02;CLI00300;FACTURA;35;1;58006;11021;69027
FAC0039338;2015-05-22;CLI00366;FACTURA;31;1;114365;21729;136094
FAC0039339;2015-10-19;CLI00674;FACTURA;48;1;104412;19838;124250
FAC0039340;2015-05-01;CLI00485;FACTURA;46;2;43610;8286;51896
FAC0039341;2015-11-07;CLI00012;FACTURA;8;1;96210;18280;114490
FAC0039342;2015-02-11;CLI00258;FACTURA;42;1;90556;17206;107762
FAC0039343;2015-01-08;CLI00111;FACTURA;47;2;40686;7730;48416
FAC0039344;2015-06-16;CLI00701;FACTURA;6;2;76419;14520;90939
FAC0039345;2015-12-09;CLI00396;FACTURA;32;1;143340;27235;170575
FAC0039346;2015-07-13;CLI00550;FACTURA;34;1;202384;38453;240837
FAC0039347;2015-06-06;CLI00470;FACTURA;40;1;245187;46586;291773
FAC0039348;2015-06-11;CLI00206;FACTURA;15;1;217944;41409;259353
FAC0039349;2015-02-21;CLI00853;FACTURA;33;2;94485;17952;112437
FAC0039350;2015-11-28;CLI00991;FACTURA;49;2;98298;18677;116975
FAC0039351;2015-01-08;CLI00582;FACTURA;3;1;85524;16250;101774
FAC0039352;2015-10-10;CLI00276;FACTURA;18;1;196904;37412;234316
FAC0039353;2015-12-02;CLI00495;FACTURA;7;2;348040;66128;414168
FAC0039354;2015-01-22;CLI00302;FACTURA;17;1;33792;6420;40212
FAC0039355;2015-12-14;CLI00752;FACTURA;48;1;123340;23435;146775
FAC0039356;2015-06-12;CLI00271;FACTURA;45;2;87220;16572;103792
FAC0039357;2015-10-17;CLI00195;FACTURA;5;2;39730;7549;47279
FAC0039358;2015-02-14;CLI00999;FACTURA;45;2;75588;14362;89950
FAC0039359;2015-04-23;CLI00801;FACTURA;1;2;130830;24858;155688
FAC0039360;2015-11-02;CLI00678;FACTURA;9;1;9483;1802;11285
FAC0039361;2015-12-03;CLI00824;FACTURA;15;1;66381;12612;78993
FAC0039362;2015-03-09;CLI00386;FACTURA;50;1;109295;20766;130061
FAC0039363;2015-03-30;CLI00420;FACTURA;32;1;32070;6093;38163
FAC0039364;2015-04-12;CLI00756;FACTURA;40;1;21410;4068;25478
FAC0039365;2015-08-27;CLI00055;FACTURA;1;2;221672;42118;263790
FAC0039366;2015-11-06;CLI00565;FACTURA;9;2;71502;13585;85087
FAC0039367;2015-05-31;CLI00006;FACTURA;47;1;174018;33063;207081
FAC0039368;2015-02-18;CLI00155;FACTURA;6;2;33844;6430;40274
FAC0039369;2015-05-27;CLI00529;FACTURA;6;2;100735;19140;119875
FAC0039370;2015-01-13;CLI00105;FACTURA;40;2;227682;43260;270942
FAC0039371;2015-02-24;CLI00629;FACTURA;48;2;83419;15850;99269
FAC0039372;2015-01-21;CLI00786;FACTURA;50;1;102010;19382;121392
FAC0039373;2015-12-17;CLI00972;FACTURA;16;1;114540;21763;136303
FAC0039374;2015-04-25;CLI00968;FACTURA;37;1;239309;45469;284778
FAC0039375;2015-03-02;CLI00959;FACTURA;13;2;158724;30158;188882
FAC0039376;2015-04-25;CLI00425;FACTURA;11;2;61790;11740;73530
FAC0039377;2015-06-20;CLI00693;FACTURA;4;2;195060;37061;232121
FAC0039378;2015-03-27;CLI00073;FACTURA;28;2;160111;30421;190532
FAC0039379;2015-07-17;CLI00160;FACTURA;20;1;152635;29001;181636
FAC0039380;2015-05-27;CLI00787;FACTURA;25;2;135355;25717;161072
FAC0039381;2015-07-29;CLI00827;FACTURA;20;2;147819;28086;175905
FAC0039382;2015-09-25;CLI00327;FACTURA;13;2;203430;38652;242082
FAC0039383;2015-10-09;CLI00507;FACTURA;26;2;145224;27593;172817
FAC0039384;2015-11-09;CLI00135;FACTURA;28;2;119170;22642;141812
FAC0039385;2015-08-23;CLI00700;FACTURA;27;1;177086;33646;210732
FAC0039386;2015-11-26;CLI00232;FACTURA;3;1;34187;6496;40683
FAC0039387;2015-04-07;CLI00764;FACTURA;6;1;152838;29039;181877
FAC0039388;2015-05-12;CLI00584;FACTURA;2;1;252999;48070;301069
FAC0039389;2015-05-13;CLI00236;FACTURA;18;1;272430;51762;324192
FAC0039390;2015-02-15;CLI00911;FACTURA;31;2;171048;32499;203547
FAC0039391;2015-09-15;CLI00297;FACTURA;11;2;159498;30305;189803
FAC0039392;2015-12-27;CLI00837;FACTURA;20;2;226390;43014;269404
FAC0039393;2015-09-05;CLI00864;FACTURA;25;1;144315;27420;171735
FAC0039394;2015-03-22;CLI00414;FACTURA;27;1;22639;4301;26940
FAC0039395;2015-01-25;CLI00149;FACTURA;3;2;34187;6496;40683
FAC0039396;2015-09-29;CLI00097;FACTURA;26;2;100735;19140;119875
FAC0039397;2015-10-30;CLI00692;FACTURA;30;1;188970;35904;224874
FAC0039398;2015-01-25;CLI00371;FACTURA;39;2;16136;3066;19202
FAC0039399;2015-02-03;CLI00843;FACTURA;28;2;91809;17444;109253
FAC0039400;2015-11-21;CLI00497;FACTURA;9;2;76419;14520;90939
FAC0039401;2015-10-07;CLI00520;FACTURA;31;1;261027;49595;310622
FAC0039402;2015-01-30;CLI00952;FACTURA;21;1;94460;17947;112407
FAC0039403;2015-07-29;CLI00274;FACTURA;41;1;100735;19140;119875
FAC0039404;2015-07-23;CLI00044;FACTURA;48;1;347100;65949;413049
FAC0039405;2015-03-18;CLI00364;FACTURA;50;1;229257;43559;272816
FAC0039406;2015-06-02;CLI00860;FACTURA;11;1;217944;41409;259353
FAC0039407;2015-02-22;CLI00366;FACTURA;9;1;60876;11566;72442
FAC0039408;2015-11-25;CLI00971;FACTURA;6;2;156048;29649;185697
FAC0039409;2015-06-08;CLI00555;FACTURA;23;2;158724;30158;188882
FAC0039410;2015-08-18;CLI00321;FACTURA;18;2;11917;2264;14181
FAC0039411;2015-03-13;CLI00691;FACTURA;28;2;42234;8024;50258
FAC0039412;2015-02-21;CLI00061;FACTURA;17;2;5638;1071;6709
FAC0039413;2015-04-01;CLI00222;FACTURA;48;1;56676;10768;67444
FAC0039414;2015-03-09;CLI00953;FACTURA;37;2;101892;19359;121251
FAC0039415;2015-07-21;CLI00319;FACTURA;32;2;31784;6039;37823
FAC0039416;2015-05-11;CLI00983;FACTURA;43;2;16136;3066;19202
FAC0039417;2015-01-11;CLI00924;FACTURA;17;1;178311;33879;212190
FAC0039418;2015-07-25;CLI00664;FACTURA;45;1;24716;4696;29412
FAC0039419;2015-12-15;CLI00730;FACTURA;20;1;254060;48271;302331
FAC0039420;2015-12-20;CLI00556;FACTURA;38;1;69420;13190;82610
FAC0039421;2015-05-15;CLI00126;FACTURA;43;1;111030;21096;132126
FAC0039422;2015-03-31;CLI00740;FACTURA;25;1;28508;5417;33925
FAC0039423;2015-04-11;CLI00391;FACTURA;44;2;57016;10833;67849
FAC0039424;2015-09-21;CLI00346;FACTURA;26;1;221517;42088;263605
FAC0039425;2015-11-09;CLI00130;FACTURA;42;1;168666;32047;200713
FAC0039426;2015-02-01;CLI00128;FACTURA;3;1;268776;51067;319843
FAC0039427;2015-04-12;CLI00988;FACTURA;48;1;176360;33508;209868
FAC0039428;2015-07-26;CLI00417;FACTURA;42;2;39012;7412;46424
FAC0039429;2015-01-08;CLI00381;FACTURA;48;2;151176;28723;179899
FAC0039430;2015-03-10;CLI00691;FACTURA;40;2;43002;8170;51172
FAC0039431;2015-08-01;CLI00451;FACTURA;14;2;16035;3047;19082
FAC0039432;2015-12-27;CLI00655;FACTURA;46;2;73839;14029;87868
FAC0039433;2015-09-17;CLI00933;FACTURA;16;2;61206;11629;72835
FAC0039434;2015-04-08;CLI00077;FACTURA;9;2;277090;52647;329737
FAC0039435;2015-05-28;CLI00966;FACTURA;14;1;5638;1071;6709
FAC0039436;2015-03-07;CLI00660;FACTURA;7;1;25473;4840;30313
FAC0039437;2015-01-27;CLI00182;FACTURA;24;1;32070;6093;38163
FAC0039438;2015-07-22;CLI00119;FACTURA;9;2;149870;28475;178345
FAC0039439;2015-02-21;CLI00381;FACTURA;49;2;294894;56030;350924
FAC0039440;2015-12-14;CLI00375;FACTURA;34;2;261027;49595;310622
FAC0039441;2015-09-12;CLI00535;FACTURA;33;2;104412;19838;124250
FAC0039442;2015-03-15;CLI00916;FACTURA;14;1;210970;40084;251054
FAC0039443;2015-01-09;CLI00713;FACTURA;7;2;151788;28840;180628
FAC0039444;2015-03-13;CLI00253;FACTURA;25;2;335970;63834;399804
FAC0039445;2015-02-21;CLI00150;FACTURA;8;1;229257;43559;272816
FAC0039446;2015-04-18;CLI00604;FACTURA;2;1;123340;23435;146775
FAC0039447;2015-06-30;CLI00520;FACTURA;38;1;24613;4676;29289
FAC0039448;2015-08-13;CLI00042;FACTURA;18;1;173550;32975;206525
FAC0039449;2015-03-10;CLI00311;FACTURA;36;2;147819;28086;175905
FAC0039450;2015-09-04;CLI00760;FACTURA;26;1;101532;19291;120823
FAC0039451;2015-08-13;CLI00230;FACTURA;46;1;170935;32478;203413
FAC0039452;2015-01-20;CLI00306;FACTURA;6;1;101192;19226;120418
FAC0039453;2015-04-25;CLI00979;FACTURA;45;2;22206;4219;26425
FAC0039454;2015-02-15;CLI00509;FACTURA;22;2;277090;52647;329737
FAC0039455;2015-07-31;CLI00955;FACTURA;24;2;40294;7656;47950
FAC0039456;2015-08-22;CLI00870;FACTURA;47;1;142401;27056;169457
FAC0039457;2015-08-18;CLI00222;FACTURA;39;1;341870;64955;406825
FAC0039458;2015-10-14;CLI00251;FACTURA;30;2;87220;16572;103792
FAC0039459;2015-04-29;CLI00303;FACTURA;49;2;81168;15422;96590
FAC0039460;2015-07-09;CLI00111;FACTURA;30;2;49360;9378;58738
FAC0039461;2015-03-25;CLI00244;FACTURA;37;1;82044;15588;97632
FAC0039462;2015-10-23;CLI00541;FACTURA;44;2;39730;7549;47279
FAC0039463;2015-02-08;CLI00992;FACTURA;49;1;48408;9198;57606
FAC0039464;2015-02-18;CLI00757;FACTURA;23;2;132915;25254;158169
FAC0039465;2015-02-19;CLI00812;FACTURA;29;1;16922;3215;20137
FAC0039466;2015-11-14;CLI00471;FACTURA;13;2;341870;64955;406825
FAC0039467;2015-01-25;CLI00724;FACTURA;34;1;68370;12990;81360
FAC0039468;2015-03-13;CLI00109;FACTURA;21;2;208260;39569;247829
FAC0039469;2015-03-30;CLI00089;FACTURA;27;2;239247;45457;284704
FAC0039470;2015-06-06;CLI00230;FACTURA;14;1;54696;10392;65088
FAC0039471;2015-03-04;CLI00386;FACTURA;30;1;33792;6420;40212
FAC0039472;2015-12-19;CLI00369;FACTURA;50;2;56222;10682;66904
FAC0039473;2015-02-28;CLI00585;FACTURA;13;2;71670;13617;85287
FAC0039474;2015-10-24;CLI00944;FACTURA;32;1;55611;10566;66177
FAC0039475;2015-05-01;CLI00889;FACTURA;31;2;335970;63834;399804
FAC0039476;2015-03-09;CLI00797;FACTURA;1;2;114032;21666;135698
FAC0039477;2015-06-13;CLI00456;FACTURA;42;1;76032;14446;90478
FAC0039478;2015-09-16;CLI00499;FACTURA;10;2;129006;24511;153517
FAC0039479;2015-01-05;CLI00717;FACTURA;1;2;158473;30110;188583
FAC0039480;2015-05-23;CLI00936;FACTURA;29;1;83127;15794;98921
FAC0039481;2015-12-14;CLI00972;FACTURA;37;1;55622;10568;66190
FAC0039482;2015-01-06;CLI00610;FACTURA;21;1;252999;48070;301069
FAC0039483;2015-10-31;CLI00568;FACTURA;41;1;65415;12429;77844
FAC0039484;2015-09-09;CLI00824;FACTURA;16;1;123065;23382;146447
FAC0039485;2015-04-23;CLI00003;FACTURA;3;2;37794;7181;44975
FAC0039486;2015-04-08;CLI00092;FACTURA;50;1;177086;33646;210732
FAC0039487;2015-05-22;CLI00257;FACTURA;9;2;201470;38279;239749
FAC0039488;2015-01-22;CLI00771;FACTURA;2;2;75894;14420;90314
FAC0039489;2015-05-01;CLI00418;FACTURA;45;1;116012;22042;138054
FAC0039490;2015-05-04;CLI00451;FACTURA;45;2;137238;26075;163313
FAC0039491;2015-08-01;CLI00470;FACTURA;42;1;75864;14414;90278
FAC0039492;2015-12-26;CLI00028;FACTURA;11;1;129006;24511;153517
FAC0039493;2015-05-23;CLI00870;FACTURA;5;1;98298;18677;116975
FAC0039494;2015-08-09;CLI00710;FACTURA;23;1;210970;40084;251054
FAC0039495;2015-03-15;CLI00165;FACTURA;4;2;52395;9955;62350
FAC0039496;2015-07-25;CLI00815;FACTURA;36;2;76032;14446;90478
FAC0039497;2015-12-25;CLI00798;FACTURA;42;1;81168;15422;96590
FAC0039498;2015-03-17;CLI00265;FACTURA;2;2;43190;8206;51396
FAC0039499;2015-09-30;CLI00706;FACTURA;44;1;55611;10566;66177
FAC0039500;2015-08-05;CLI00974;FACTURA;25;1;42240;8026;50266
FAC0039501;2015-10-24;CLI00182;FACTURA;5;1;171048;32499;203547
FAC0039502;2015-03-28;CLI00106;FACTURA;11;1;136748;25982;162730
FAC0039503;2015-02-07;CLI00052;FACTURA;2;1;151176;28723;179899
FAC0039504;2015-09-18;CLI00211;FACTURA;21;2;32766;6226;38992
FAC0039505;2015-12-05;CLI00931;FACTURA;40;2;18897;3590;22487
FAC0039506;2015-05-02;CLI00128;FACTURA;35;1;71502;13585;85087
FAC0039507;2015-10-02;CLI00293;FACTURA;10;2;45746;8692;54438
FAC0039508;2015-05-30;CLI00318;FACTURA;24;1;188970;35904;224874
FAC0039509;2015-03-28;CLI00924;FACTURA;9;1;249381;47382;296763
FAC0039510;2015-02-12;CLI00647;FACTURA;45;2;120882;22968;143850
FAC0039511;2015-12-22;CLI00847;FACTURA;22;2;75568;14358;89926
FAC0039512;2015-10-01;CLI00408;FACTURA;15;1;273496;51964;325460
FAC0039513;2015-04-09;CLI00514;FACTURA;6;1;177648;33753;211401
FAC0039514;2015-09-03;CLI00844;FACTURA;5;1;262128;49804;311932
FAC0039515;2015-03-04;CLI00454;FACTURA;2;1;37794;7181;44975
FAC0039516;2015-10-11;CLI00589;FACTURA;27;2;228654;43444;272098
FAC0039517;2015-11-11;CLI00921;FACTURA;22;2;84468;16049;100517
FAC0039518;2015-08-23;CLI00294;FACTURA;50;1;66381;12612;78993
FAC0039519;2015-04-19;CLI00601;FACTURA;32;2;44412;8438;52850
FAC0039520;2015-05-18;CLI00653;FACTURA;3;2;112444;21364;133808
FAC0039521;2015-06-14;CLI00996;FACTURA;4;1;43190;8206;51396
FAC0039522;2015-10-25;CLI00670;FACTURA;32;1;186081;35355;221436
FAC0039523;2015-10-10;CLI00381;FACTURA;9;2;160111;30421;190532
FAC0039524;2015-05-22;CLI00353;FACTURA;44;2;208260;39569;247829
FAC0039525;2015-05-19;CLI00133;FACTURA;22;2;129088;24527;153615
FAC0039526;2015-09-12;CLI00611;FACTURA;10;2;135834;25808;161642
FAC0039527;2015-08-10;CLI00527;FACTURA;5;2;159498;30305;189803
FAC0039528;2015-08-07;CLI00329;FACTURA;24;2;152436;28963;181399
FAC0039529;2015-02-23;CLI00728;FACTURA;15;1;126490;24033;150523
FAC0039530;2015-06-17;CLI00787;FACTURA;6;2;152298;28937;181235
FAC0039531;2015-11-30;CLI00555;FACTURA;21;2;132915;25254;158169
FAC0039532;2015-03-31;CLI00648;FACTURA;43;1;76032;14446;90478
FAC0039533;2015-06-02;CLI00382;FACTURA;4;1;63351;12037;75388
FAC0039534;2015-08-07;CLI00460;FACTURA;31;1;52395;9955;62350
FAC0039535;2015-11-10;CLI00440;FACTURA;35;1;17636;3351;20987
FAC0039536;2015-08-07;CLI00325;FACTURA;33;2;84480;16051;100531
FAC0039537;2015-01-10;CLI00793;FACTURA;23;2;25298;4807;30105
FAC0039538;2015-10-06;CLI00541;FACTURA;14;2;65532;12451;77983
FAC0039539;2015-07-19;CLI00362;FACTURA;32;1;13674;2598;16272
FAC0039540;2015-11-04;CLI00550;FACTURA;12;1;203430;38652;242082
FAC0039541;2015-09-06;CLI00824;FACTURA;24;1;136740;25981;162721
FAC0039542;2015-01-14;CLI00111;FACTURA;27;2;68374;12991;81365
FAC0039543;2015-01-23;CLI00838;FACTURA;10;1;199556;37916;237472
FAC0039544;2015-03-21;CLI00370;FACTURA;33;1;51005;9691;60696
FAC0039545;2015-04-12;CLI00388;FACTURA;48;1;221517;42088;263605
FAC0039546;2015-01-13;CLI00648;FACTURA;39;1;16035;3047;19082
FAC0039547;2015-12-26;CLI00442;FACTURA;38;1;57016;10833;67849
FAC0039548;2015-08-19;CLI00338;FACTURA;46;1;78024;14825;92849
FAC0039549;2015-07-01;CLI00286;FACTURA;42;1;196904;37412;234316
FAC0039550;2015-08-15;CLI00322;FACTURA;23;1;95336;18114;113450
FAC0039551;2015-04-10;CLI00029;FACTURA;9;2;81372;15461;96833
FAC0039552;2015-06-18;CLI00839;FACTURA;32;2;27243;5176;32419
FAC0039553;2015-12-05;CLI00748;FACTURA;17;1;20402;3876;24278
FAC0039554;2015-11-30;CLI00133;FACTURA;17;2;80175;15233;95408
FAC0039555;2015-08-20;CLI00625;FACTURA;10;2;222060;42191;264251
FAC0039556;2015-01-03;CLI00220;FACTURA;30;1;91314;17350;108664
FAC0039557;2015-03-01;CLI00328;FACTURA;17;1;56222;10682;66904
FAC0039558;2015-07-23;CLI00958;FACTURA;33;1;57336;10894;68230
FAC0039559;2015-06-03;CLI00148;FACTURA;23;1;137238;26075;163313
FAC0039560;2015-12-16;CLI00713;FACTURA;37;2;7946;1510;9456
FAC0039561;2015-11-19;CLI00421;FACTURA;27;2;119170;22642;141812
FAC0039562;2015-05-30;CLI00702;FACTURA;18;1;178311;33879;212190
FAC0039563;2015-08-19;CLI00654;FACTURA;5;1;91632;17410;109042
FAC0039564;2015-04-20;CLI00349;FACTURA;39;2;218590;41532;260122
FAC0039565;2015-06-15;CLI00102;FACTURA;9;1;183087;34787;217874
FAC0039566;2015-07-28;CLI00033;FACTURA;44;2;9446;1795;11241
FAC0039567;2015-09-26;CLI00509;FACTURA;12;2;12340;2345;14685
FAC0039568;2015-02-22;CLI00916;FACTURA;31;1;229257;43559;272816
FAC0039569;2015-11-08;CLI00797;FACTURA;38;2;153013;29072;182085
FAC0039570;2015-06-01;CLI00439;FACTURA;9;2;281110;53411;334521
FAC0039571;2015-02-03;CLI00342;FACTURA;10;1;151788;28840;180628
FAC0039572;2015-05-23;CLI00701;FACTURA;19;2;168776;32067;200843
FAC0039573;2015-06-29;CLI00398;FACTURA;25;1;84388;16034;100422
FAC0039574;2015-11-22;CLI00400;FACTURA;34;1;16136;3066;19202
FAC0039575;2015-10-24;CLI00577;FACTURA;28;2;138840;26380;165220
FAC0039576;2015-12-24;CLI00483;FACTURA;18;2;45278;8603;53881
FAC0039577;2015-07-29;CLI00009;FACTURA;7;2;252980;48066;301046
FAC0039578;2015-07-22;CLI00178;FACTURA;35;1;6179;1174;7353
FAC0039579;2015-09-08;CLI00476;FACTURA;47;1;28508;5417;33925
FAC0039580;2015-08-09;CLI00272;FACTURA;49;1;43610;8286;51896
FAC0039581;2015-11-09;CLI00178;FACTURA;39;1;40294;7656;47950
FAC0039582;2015-09-14;CLI00384;FACTURA;34;1;28668;5447;34115
FAC0039583;2015-02-28;CLI00610;FACTURA;26;1;68619;13038;81657
FAC0039584;2015-06-09;CLI00643;FACTURA;13;2;126702;24073;150775
FAC0039585;2015-03-16;CLI00020;FACTURA;7;1;67584;12841;80425
FAC0039586;2015-03-19;CLI00877;FACTURA;49;2;28508;5417;33925
FAC0039587;2015-08-08;CLI00577;FACTURA;34;2;228730;43459;272189
FAC0039588;2015-09-16;CLI00597;FACTURA;49;2;24716;4696;29412
FAC0039589;2015-12-10;CLI00970;FACTURA;26;1;214100;40679;254779
FAC0039590;2015-07-24;CLI00578;FACTURA;18;1;170935;32478;203413
FAC0039591;2015-07-21;CLI00334;FACTURA;28;1;172676;32808;205484
FAC0039592;2015-08-22;CLI00649;FACTURA;32;2;106332;20203;126535
FAC0039593;2015-06-04;CLI00404;FACTURA;4;1;158473;30110;188583
FAC0039594;2015-03-17;CLI00594;FACTURA;38;1;100338;19064;119402
FAC0039595;2015-06-25;CLI00561;FACTURA;23;2;21805;4143;25948
FAC0039596;2015-11-17;CLI00296;FACTURA;5;1;9446;1795;11241
FAC0039597;2015-08-26;CLI00953;FACTURA;27;2;147679;28059;175738
FAC0039598;2015-10-20;CLI00301;FACTURA;49;2;109295;20766;130061
FAC0039599;2015-09-16;CLI00219;FACTURA;19;2;348040;66128;414168
FAC0039600;2015-05-16;CLI00778;FACTURA;34;1;166254;31588;197842
FAC0039601;2015-01-05;CLI00359;FACTURA;42;2;30603;5815;36418
FAC0039602;2015-06-27;CLI00167;FACTURA;28;2;57016;10833;67849
FAC0039603;2015-02-24;CLI00756;FACTURA;44;1;71514;13588;85102
FAC0039604;2015-05-11;CLI00569;FACTURA;9;2;112245;21327;133572
FAC0039605;2015-10-31;CLI00321;FACTURA;40;2;133236;25315;158551
FAC0039606;2015-10-13;CLI00268;FACTURA;20;1;45816;8705;54521
FAC0039607;2015-12-28;CLI00721;FACTURA;48;2;98452;18706;117158
FAC0039608;2015-11-29;CLI00163;FACTURA;48;2;116012;22042;138054
FAC0039609;2015-10-31;CLI00662;FACTURA;38;1;37794;7181;44975
FAC0039610;2015-01-03;CLI00729;FACTURA;25;2;70544;13403;83947
FAC0039611;2015-10-10;CLI00315;FACTURA;41;2;277680;52759;330439
FAC0039612;2015-06-02;CLI00814;FACTURA;25;1;262128;49804;311932
FAC0039613;2015-01-18;CLI00021;FACTURA;4;2;347100;65949;413049
FAC0039614;2015-07-26;CLI00176;FACTURA;35;1;203248;38617;241865
FAC0039615;2015-05-07;CLI00734;FACTURA;21;1;61700;11723;73423
FAC0039616;2015-05-10;CLI00105;FACTURA;38;2;221672;42118;263790
FAC0039617;2015-11-11;CLI00660;FACTURA;19;1;49226;9353;58579
FAC0039618;2015-08-05;CLI00213;FACTURA;46;2;123066;23383;146449
FAC0039619;2015-12-05;CLI00267;FACTURA;13;2;96210;18280;114490
FAC0039620;2015-01-20;CLI00280;FACTURA;45;1;30850;5862;36712
FAC0039621;2015-09-06;CLI00279;FACTURA;27;2;76218;14481;90699
FAC0039622;2015-05-11;CLI00827;FACTURA;25;2;10146;1928;12074
FAC0039623;2015-12-08;CLI00095;FACTURA;28;2;8448;1605;10053
FAC0039624;2015-01-30;CLI00694;FACTURA;32;1;163458;31057;194515
FAC0039625;2015-05-27;CLI00414;FACTURA;33;1;174018;33063;207081
FAC0039626;2015-05-26;CLI00268;FACTURA;47;1;123066;23383;146449
FAC0039627;2015-09-17;CLI00809;FACTURA;44;2;11454;2176;13630
FAC0039628;2015-09-29;CLI00207;FACTURA;45;2;217944;41409;259353
FAC0039629;2015-01-13;CLI00896;FACTURA;19;1;201470;38279;239749
FAC0039630;2015-05-22;CLI00129;FACTURA;44;2;203021;38574;241595
FAC0039631;2015-07-27;CLI00675;FACTURA;8;2;101624;19309;120933
FAC0039632;2015-06-21;CLI00047;FACTURA;36;2;16914;3214;20128
FAC0039633;2015-11-03;CLI00205;FACTURA;41;2;174872;33226;208098
FAC0039634;2015-12-22;CLI00598;FACTURA;14;1;84388;16034;100422
FAC0039635;2015-07-12;CLI00285;FACTURA;14;2;217944;41409;259353
FAC0039636;2015-03-15;CLI00923;FACTURA;28;2;114032;21666;135698
FAC0039637;2015-03-01;CLI00730;FACTURA;5;1;85014;16153;101167
FAC0039638;2015-10-29;CLI00564;FACTURA;11;1;55530;10551;66081
FAC0039639;2015-11-11;CLI00266;FACTURA;32;1;37932;7207;45139
FAC0039640;2015-09-24;CLI00019;FACTURA;27;2;26583;5051;31634
FAC0039641;2015-01-02;CLI00691;FACTURA;43;2;6170;1172;7342
FAC0039642;2015-06-16;CLI00005;FACTURA;35;2;173550;32975;206525
FAC0039643;2015-02-19;CLI00768;FACTURA;32;1;65532;12451;77983
FAC0039644;2015-10-28;CLI00519;FACTURA;16;2;183087;34787;217874
FAC0039645;2015-12-13;CLI00882;FACTURA;36;1;85640;16272;101912
FAC0039646;2015-04-23;CLI00832;FACTURA;8;1;130830;24858;155688
FAC0039647;2015-05-10;CLI00467;FACTURA;25;2;104412;19838;124250
FAC0039648;2015-03-30;CLI00863;FACTURA;35;2;278432;52902;331334
FAC0039649;2015-11-16;CLI00138;FACTURA;49;1;56676;10768;67444
FAC0039650;2015-10-13;CLI00462;FACTURA;12;1;114540;21763;136303
FAC0039651;2015-09-10;CLI00278;FACTURA;9;1;160111;30421;190532
FAC0039652;2015-03-17;CLI00859;FACTURA;30;2;128280;24373;152653
FAC0039653;2015-05-27;CLI00266;FACTURA;17;1;104790;19910;124700
FAC0039654;2015-11-26;CLI00721;FACTURA;33;2;52395;9955;62350
FAC0039655;2015-08-06;CLI00861;FACTURA;40;2;65577;12460;78037
FAC0039656;2015-08-21;CLI00403;FACTURA;49;2;114540;21763;136303
FAC0039657;2015-10-22;CLI00382;FACTURA;27;1;152838;29039;181877
FAC0039658;2015-03-05;CLI00880;FACTURA;42;1;113382;21543;134925
FAC0039659;2015-02-27;CLI00205;FACTURA;19;2;161360;30658;192018
FAC0039660;2015-06-02;CLI00431;FACTURA;33;2;243628;46289;289917
FAC0039661;2015-04-20;CLI00369;FACTURA;27;2;203430;38652;242082
FAC0039662;2015-03-21;CLI00901;FACTURA;30;2;61206;11629;72835
FAC0039663;2015-03-24;CLI00452;FACTURA;18;1;11917;2264;14181
FAC0039664;2015-05-06;CLI00887;FACTURA;16;2;27243;5176;32419
FAC0039665;2015-05-17;CLI00873;FACTURA;15;2;239247;45457;284704
FAC0039666;2015-05-27;CLI00907;FACTURA;38;2;116012;22042;138054
FAC0039667;2015-07-29;CLI00087;FACTURA;14;2;114540;21763;136303
FAC0039668;2015-06-27;CLI00957;FACTURA;33;2;118454;22506;140960
FAC0039669;2015-11-06;CLI00994;FACTURA;29;1;39730;7549;47279
FAC0039670;2015-01-22;CLI00629;FACTURA;37;2;277090;52647;329737
FAC0039671;2015-03-22;CLI00407;FACTURA;21;2;210970;40084;251054
FAC0039672;2015-09-10;CLI00941;FACTURA;46;2;56676;10768;67444
FAC0039673;2015-05-29;CLI00879;FACTURA;38;2;347100;65949;413049
FAC0039674;2015-03-25;CLI00371;FACTURA;1;2;73353;13937;87290
FAC0039675;2015-05-19;CLI00795;FACTURA;35;2;123452;23456;146908
FAC0039676;2015-02-26;CLI00833;FACTURA;24;2;177648;33753;211401
FAC0039677;2015-04-20;CLI00553;FACTURA;19;2;153013;29072;182085
FAC0039678;2015-10-02;CLI00261;FACTURA;19;2;278432;52902;331334
FAC0039679;2015-12-01;CLI00460;FACTURA;5;1;66381;12612;78993
FAC0039680;2015-09-01;CLI00226;FACTURA;13;1;114672;21788;136460
FAC0039681;2015-06-02;CLI00980;FACTURA;18;1;81372;15461;96833
FAC0039682;2015-12-29;CLI00994;FACTURA;5;1;216568;41148;257716
FAC0039683;2015-11-18;CLI00411;FACTURA;25;2;277090;52647;329737
FAC0039684;2015-06-27;CLI00180;FACTURA;21;1;254730;48399;303129
FAC0039685;2015-02-21;CLI00643;FACTURA;23;2;335970;63834;399804
FAC0039686;2015-12-31;CLI00558;FACTURA;20;1;265830;50508;316338
FAC0039687;2015-08-15;CLI00949;FACTURA;1;2;75894;14420;90314
FAC0039688;2015-02-02;CLI00327;FACTURA;26;2;136740;25981;162721
FAC0039689;2015-05-11;CLI00161;FACTURA;21;2;27348;5196;32544
FAC0039690;2015-07-01;CLI00539;FACTURA;12;2;45278;8603;53881
FAC0039691;2015-08-11;CLI00412;FACTURA;7;1;56676;10768;67444
FAC0039692;2015-03-10;CLI00028;FACTURA;7;1;224888;42729;267617
FAC0039693;2015-11-13;CLI00695;FACTURA;30;2;40294;7656;47950
FAC0039694;2015-09-17;CLI00297;FACTURA;11;2;123066;23383;146449
FAC0039695;2015-07-12;CLI00474;FACTURA;16;1;28190;5356;33546
FAC0039696;2015-03-10;CLI00805;FACTURA;5;2;136542;25943;162485
FAC0039697;2015-06-09;CLI00360;FACTURA;31;1;135376;25721;161097
FAC0039698;2015-07-18;CLI00782;FACTURA;19;1;145015;27553;172568
FAC0039699;2015-10-26;CLI00423;FACTURA;50;2;49336;9374;58710
FAC0039700;2015-03-10;CLI00350;FACTURA;4;1;50742;9641;60383
FAC0039701;2015-09-24;CLI00761;FACTURA;7;2;168776;32067;200843
FAC0039702;2015-06-16;CLI00317;FACTURA;15;2;75894;14420;90314
FAC0039703;2015-02-20;CLI00461;FACTURA;50;2;24716;4696;29412
FAC0039704;2015-05-17;CLI00495;FACTURA;11;2;70544;13403;83947
FAC0039705;2015-11-03;CLI00520;FACTURA;27;1;177086;33646;210732
FAC0039706;2015-12-28;CLI00667;FACTURA;50;2;79460;15097;94557
FAC0039707;2015-08-31;CLI00466;FACTURA;1;1;56676;10768;67444
FAC0039708;2015-04-05;CLI00552;FACTURA;2;1;59585;11321;70906
FAC0039709;2015-12-17;CLI00784;FACTURA;38;1;114365;21729;136094
FAC0039710;2015-12-15;CLI00435;FACTURA;16;2;47415;9009;56424
FAC0039711;2015-04-03;CLI00416;FACTURA;44;1;158473;30110;188583
FAC0039712;2015-03-17;CLI00266;FACTURA;2;1;54142;10287;64429
FAC0039713;2015-11-15;CLI00066;FACTURA;48;1;152436;28963;181399
FAC0039714;2015-01-21;CLI00269;FACTURA;40;2;243639;46291;289930
FAC0039715;2015-07-18;CLI00137;FACTURA;6;2;152298;28937;181235
FAC0039716;2015-03-29;CLI00957;FACTURA;19;2;113382;21543;134925
FAC0039717;2015-06-23;CLI00823;FACTURA;31;2;49432;9392;58824
FAC0039718;2015-09-16;CLI00958;FACTURA;9;1;192690;36611;229301
FAC0039719;2015-03-26;CLI00707;FACTURA;18;2;261027;49595;310622
FAC0039720;2015-01-09;CLI00338;FACTURA;42;1;39730;7549;47279
FAC0039721;2015-03-19;CLI00303;FACTURA;44;2;205857;39113;244970
FAC0039722;2015-06-03;CLI00670;FACTURA;20;1;73839;14029;87868
FAC0039723;2015-07-01;CLI00355;FACTURA;13;2;57270;10881;68151
FAC0039724;2015-08-02;CLI00189;FACTURA;14;2;129006;24511;153517
FAC0039725;2015-07-31;CLI00176;FACTURA;40;1;33844;6430;40274
FAC0039726;2015-11-08;CLI00046;FACTURA;25;1;29003;5511;34514
FAC0039727;2015-01-04;CLI00977;FACTURA;20;2;196731;37379;234110
FAC0039728;2015-02-26;CLI00113;FACTURA;16;2;186081;35355;221436
FAC0039729;2015-04-15;CLI00903;FACTURA;13;2;307683;58460;366143
FAC0039730;2015-04-24;CLI00327;FACTURA;35;2;112952;21461;134413
FAC0039731;2015-07-14;CLI00604;FACTURA;46;1;21805;4143;25948
FAC0039732;2015-08-10;CLI00276;FACTURA;13;1;27348;5196;32544
FAC0039733;2015-05-25;CLI00066;FACTURA;12;1;63568;12078;75646
FAC0039734;2015-09-28;CLI00818;FACTURA;6;1;48105;9140;57245
FAC0039735;2015-02-13;CLI00211;FACTURA;38;2;56222;10682;66904
FAC0039736;2015-03-30;CLI00669;FACTURA;29;2;104412;19838;124250
FAC0039737;2015-02-02;CLI00288;FACTURA;49;1;91492;17383;108875
FAC0039738;2015-04-23;CLI00242;FACTURA;20;1;145224;27593;172817
FAC0039739;2015-05-17;CLI00066;FACTURA;10;1;34804;6613;41417
FAC0039740;2015-09-28;CLI00487;FACTURA;16;2;87220;16572;103792
FAC0039741;2015-01-21;CLI00057;FACTURA;43;2;61029;11596;72625
FAC0039742;2015-07-30;CLI00855;FACTURA;6;2;71022;13494;84516
FAC0039743;2015-04-02;CLI00479;FACTURA;31;2;252980;48066;301046
FAC0039744;2015-01-15;CLI00593;FACTURA;48;2;9483;1802;11285
FAC0039745;2015-05-17;CLI00086;FACTURA;19;1;103086;19586;122672
FAC0039746;2015-09-05;CLI00918;FACTURA;10;1;249381;47382;296763
FAC0039747;2015-03-02;CLI00051;FACTURA;48;2;20402;3876;24278
FAC0039748;2015-02-09;CLI00785;FACTURA;8;2;228730;43459;272189
FAC0039749;2015-04-15;CLI00100;FACTURA;3;1;183087;34787;217874
FAC0039750;2015-02-07;CLI00966;FACTURA;19;1;21410;4068;25478
FAC0039751;2015-03-03;CLI00762;FACTURA;27;1;6179;1174;7353
FAC0039752;2015-11-01;CLI00957;FACTURA;38;2;21410;4068;25478
FAC0039753;2015-06-20;CLI00736;FACTURA;42;1;16136;3066;19202
FAC0039754;2015-12-19;CLI00252;FACTURA;37;1;40804;7753;48557
FAC0039755;2015-01-11;CLI00342;FACTURA;24;1;98298;18677;116975
FAC0039756;2015-11-25;CLI00414;FACTURA;8;1;113195;21507;134702
FAC0039757;2015-10-29;CLI00809;FACTURA;45;2;91632;17410;109042
FAC0039758;2015-08-08;CLI00191;FACTURA;19;2;147819;28086;175905
FAC0039759;2015-09-14;CLI00691;FACTURA;16;2;294894;56030;350924
FAC0039760;2015-07-06;CLI00032;FACTURA;5;1;182984;34767;217751
FAC0039761;2015-12-10;CLI00531;FACTURA;31;2;161176;30623;191799
FAC0039762;2015-01-10;CLI00438;FACTURA;20;1;190053;36110;226163
FAC0039763;2015-05-16;CLI00588;FACTURA;49;1;69420;13190;82610
FAC0039764;2015-10-23;CLI00333;FACTURA;14;2;28190;5356;33546
FAC0039765;2015-07-17;CLI00463;FACTURA;10;2;218590;41532;260122
FAC0039766;2015-08-02;CLI00228;FACTURA;8;1;56691;10771;67462
FAC0039767;2015-06-01;CLI00656;FACTURA;3;1;81372;15461;96833
FAC0039768;2015-08-24;CLI00390;FACTURA;50;1;114365;21729;136094
FAC0039769;2015-10-09;CLI00286;FACTURA;17;1;63291;12025;75316
FAC0039770;2015-05-09;CLI00698;FACTURA;1;1;68374;12991;81365
FAC0039771;2015-06-01;CLI00806;FACTURA;17;1;50730;9639;60369
FAC0039772;2015-03-13;CLI00082;FACTURA;19;1;249381;47382;296763
FAC0039773;2015-02-20;CLI00374;FACTURA;6;1;21859;4153;26012
FAC0039774;2015-07-29;CLI00817;FACTURA;47;2;91314;17350;108664
FAC0039775;2015-08-03;CLI00071;FACTURA;35;2;91809;17444;109253
FAC0039776;2015-11-07;CLI00278;FACTURA;35;1;228064;43332;271396
FAC0039777;2015-02-03;CLI00038;FACTURA;27;1;73839;14029;87868
FAC0039778;2015-05-17;CLI00083;FACTURA;11;2;66122;12563;78685
FAC0039779;2015-03-22;CLI00914;FACTURA;2;1;50766;9646;60412
FAC0039780;2015-01-06;CLI00299;FACTURA;50;2;114365;21729;136094
FAC0039781;2015-07-20;CLI00991;FACTURA;35;2;163458;31057;194515
FAC0039782;2015-02-28;CLI00658;FACTURA;12;1;94485;17952;112437
FAC0039783;2015-11-05;CLI00462;FACTURA;1;1;47415;9009;56424
FAC0039784;2015-02-10;CLI00560;FACTURA;30;1;42240;8026;50266
FAC0039785;2015-03-03;CLI00749;FACTURA;2;2;83419;15850;99269
FAC0039786;2015-03-21;CLI00040;FACTURA;1;1;71022;13494;84516
FAC0039787;2015-08-27;CLI00905;FACTURA;35;2;100791;19150;119941
FAC0039788;2015-01-04;CLI00083;FACTURA;21;2;277680;52759;330439
FAC0039789;2015-10-28;CLI00226;FACTURA;26;1;84610;16076;100686
FAC0039790;2015-11-26;CLI00183;FACTURA;46;2;18966;3604;22570
FAC0039791;2015-08-29;CLI00191;FACTURA;48;2;203430;38652;242082
FAC0039792;2015-04-09;CLI00937;FACTURA;3;2;144315;27420;171735
FAC0039793;2015-01-08;CLI00299;FACTURA;44;2;105585;20061;125646
FAC0039794;2015-07-10;CLI00749;FACTURA;6;2;58006;11021;69027
FAC0039795;2015-01-27;CLI00685;FACTURA;46;2;35751;6793;42544
FAC0039796;2015-06-12;CLI00308;FACTURA;36;1;91809;17444;109253
FAC0039797;2015-08-26;CLI00592;FACTURA;39;1;273496;51964;325460
FAC0039798;2015-08-01;CLI00238;FACTURA;41;1;63291;12025;75316
FAC0039799;2015-07-10;CLI00952;FACTURA;3;1;32272;6132;38404
FAC0039800;2015-10-29;CLI00503;FACTURA;5;2;83832;15928;99760
FAC0039801;2015-11-08;CLI00766;FACTURA;34;1;166254;31588;197842
FAC0039802;2015-05-23;CLI00525;FACTURA;8;2;56380;10712;67092
FAC0039803;2015-03-28;CLI00914;FACTURA;32;1;15892;3019;18911
FAC0039804;2015-06-23;CLI00586;FACTURA;3;1;189873;36076;225949
FAC0039805;2015-05-23;CLI00533;FACTURA;42;2;54142;10287;64429
FAC0039806;2015-02-08;CLI00567;FACTURA;4;2;56691;10771;67462
FAC0039807;2015-03-10;CLI00115;FACTURA;20;2;43002;8170;51172
FAC0039808;2015-02-14;CLI00535;FACTURA;50;2;61700;11723;73423
FAC0039809;2015-07-11;CLI00424;FACTURA;35;1;203430;38652;242082
FAC0039810;2015-03-21;CLI00893;FACTURA;1;2;159498;30305;189803
FAC0039811;2015-07-10;CLI00503;FACTURA;29;2;222060;42191;264251
FAC0039812;2015-01-24;CLI00098;FACTURA;23;1;66381;12612;78993
FAC0039813;2015-05-22;CLI00975;FACTURA;39;2;24716;4696;29412
FAC0039814;2015-04-30;CLI00882;FACTURA;50;1;56676;10768;67444
FAC0039815;2015-03-15;CLI00953;FACTURA;36;2;80178;15234;95412
FAC0039816;2015-11-06;CLI00348;FACTURA;41;1;95718;18186;113904
FAC0039817;2015-08-25;CLI00033;FACTURA;4;2;32070;6093;38163
FAC0039818;2015-08-24;CLI00973;FACTURA;4;2;196904;37412;234316
FAC0039819;2015-03-26;CLI00012;FACTURA;24;1;79460;15097;94557
FAC0039820;2015-01-03;CLI00546;FACTURA;48;1;129006;24511;153517
FAC0039821;2015-05-06;CLI00104;FACTURA;42;1;147678;28059;175737
FAC0039822;2015-06-23;CLI00421;FACTURA;34;2;229257;43559;272816
FAC0039823;2015-12-08;CLI00083;FACTURA;25;2;335970;63834;399804
FAC0039824;2015-10-10;CLI00719;FACTURA;18;2;62874;11946;74820
FAC0039825;2015-12-28;CLI00099;FACTURA;26;2;64544;12263;76807
FAC0039826;2015-08-16;CLI00498;FACTURA;1;1;153013;29072;182085
FAC0039827;2015-06-09;CLI00674;FACTURA;6;1;273496;51964;325460
FAC0039828;2015-08-24;CLI00754;FACTURA;47;1;52908;10053;62961
FAC0039829;2015-02-05;CLI00909;FACTURA;27;2;222060;42191;264251
FAC0039830;2015-07-16;CLI00122;FACTURA;42;1;136542;25943;162485
FAC0039831;2015-11-19;CLI00268;FACTURA;21;1;16914;3214;20128
FAC0039832;2015-08-13;CLI00070;FACTURA;10;1;50730;9639;60369
FAC0039833;2015-09-10;CLI00956;FACTURA;10;1;129088;24527;153615
FAC0039834;2015-06-10;CLI00996;FACTURA;35;1;189873;36076;225949
FAC0039835;2015-11-20;CLI00809;FACTURA;29;2;202384;38453;240837
FAC0039836;2015-09-16;CLI00885;FACTURA;39;2;155442;29534;184976
FAC0039837;2015-01-15;CLI00850;FACTURA;15;1;37784;7179;44963
FAC0039838;2015-05-16;CLI00502;FACTURA;35;1;174020;33064;207084
FAC0039839;2015-07-21;CLI00823;FACTURA;41;2;203784;38719;242503
FAC0039840;2015-05-28;CLI00611;FACTURA;34;2;21805;4143;25948
FAC0039841;2015-04-27;CLI00979;FACTURA;9;2;63568;12078;75646
FAC0039842;2015-10-05;CLI00029;FACTURA;30;2;218590;41532;260122
FAC0039843;2015-10-25;CLI00490;FACTURA;19;1;16914;3214;20128
FAC0039844;2015-04-22;CLI00184;FACTURA;50;1;254060;48271;302331
FAC0039845;2015-07-14;CLI00415;FACTURA;21;2;149870;28475;178345
FAC0039846;2015-04-21;CLI00956;FACTURA;45;1;75568;14358;89926
FAC0039847;2015-02-08;CLI00002;FACTURA;42;1;228064;43332;271396
FAC0039848;2015-10-09;CLI00510;FACTURA;50;1;126582;24051;150633
FAC0039849;2015-06-03;CLI00853;FACTURA;42;2;101192;19226;120418
FAC0039850;2015-09-26;CLI00777;FACTURA;30;2;60876;11566;72442
FAC0039851;2015-07-29;CLI00826;FACTURA;40;1;74004;14061;88065
FAC0039852;2015-07-20;CLI00192;FACTURA;32;1;43190;8206;51396
FAC0039853;2015-04-11;CLI00931;FACTURA;8;2;81729;15529;97258
FAC0039854;2015-10-28;CLI00111;FACTURA;31;2;147678;28059;175737
FAC0039855;2015-07-30;CLI00228;FACTURA;21;1;239309;45469;284778
FAC0039856;2015-09-15;CLI00643;FACTURA;1;2;55611;10566;66177
FAC0039857;2015-03-02;CLI00019;FACTURA;36;2;199556;37916;237472
FAC0039858;2015-07-19;CLI00760;FACTURA;12;1;64230;12204;76434
FAC0039859;2015-01-30;CLI00897;FACTURA;25;2;201470;38279;239749
FAC0039860;2015-03-12;CLI00185;FACTURA;2;2;31437;5973;37410
FAC0039861;2015-12-17;CLI00072;FACTURA;15;1;210970;40084;251054
FAC0039862;2015-06-11;CLI00062;FACTURA;49;1;30850;5862;36712
FAC0039863;2015-02-23;CLI00017;FACTURA;26;2;56898;10811;67709
FAC0039864;2015-10-14;CLI00683;FACTURA;2;2;96210;18280;114490
FAC0039865;2015-11-28;CLI00891;FACTURA;40;2;116012;22042;138054
FAC0039866;2015-08-02;CLI00003;FACTURA;2;2;98672;18748;117420
FAC0039867;2015-07-13;CLI00560;FACTURA;43;1;9446;1795;11241
FAC0039868;2015-08-05;CLI00366;FACTURA;25;1;37074;7044;44118
FAC0039869;2015-03-22;CLI00272;FACTURA;36;1;42194;8017;50211
FAC0039870;2015-07-11;CLI00111;FACTURA;27;2;170935;32478;203413
FAC0039871;2015-07-15;CLI00703;FACTURA;10;2;39730;7549;47279
FAC0039872;2015-06-26;CLI00921;FACTURA;11;2;25473;4840;30313
FAC0039873;2015-10-01;CLI00265;FACTURA;40;2;42234;8024;50258
FAC0039874;2015-01-18;CLI00654;FACTURA;3;1;94485;17952;112437
FAC0039875;2015-07-24;CLI00098;FACTURA;31;1;39012;7412;46424
FAC0039876;2015-09-07;CLI00976;FACTURA;25;1;22639;4301;26940
FAC0039877;2015-02-19;CLI00932;FACTURA;47;1;21410;4068;25478
FAC0039878;2015-05-19;CLI00862;FACTURA;29;1;34187;6496;40683
FAC0039879;2015-05-07;CLI00368;FACTURA;28;1;227682;43260;270942
FAC0039880;2015-01-14;CLI00884;FACTURA;1;1;47676;9058;56734
FAC0039881;2015-12-14;CLI00841;FACTURA;48;2;216568;41148;257716
FAC0039882;2015-12-17;CLI00289;FACTURA;42;2;73839;14029;87868
FAC0039883;2015-08-05;CLI00164;FACTURA;39;1;11276;2142;13418
FAC0039884;2015-04-25;CLI00040;FACTURA;5;1;212664;40406;253070
FAC0039885;2015-11-22;CLI00849;FACTURA;47;2;246130;46765;292895
FAC0039886;2015-08-28;CLI00740;FACTURA;21;1;50688;9631;60319
FAC0039887;2015-08-18;CLI00161;FACTURA;2;2;114032;21666;135698
FAC0039888;2015-06-06;CLI00264;FACTURA;38;1;152436;28963;181399
FAC0039889;2015-06-22;CLI00307;FACTURA;42;2;188970;35904;224874
FAC0039890;2015-08-23;CLI00325;FACTURA;27;2;61790;11740;73530
FAC0039891;2015-07-30;CLI00238;FACTURA;33;1;98452;18706;117158
FAC0039892;2015-05-18;CLI00070;FACTURA;31;1;201582;38301;239883
FAC0039893;2015-03-17;CLI00959;FACTURA;47;2;149870;28475;178345
FAC0039894;2015-07-20;CLI00491;FACTURA;31;2;148008;28122;176130
FAC0039895;2015-01-04;CLI00526;FACTURA;12;1;208824;39677;248501
FAC0039896;2015-06-06;CLI00475;FACTURA;31;2;21805;4143;25948
FAC0039897;2015-01-21;CLI00183;FACTURA;27;2;33828;6427;40255
FAC0039898;2015-11-23;CLI00095;FACTURA;40;2;212664;40406;253070
FAC0039899;2015-07-13;CLI00513;FACTURA;37;2;221517;42088;263605
FAC0039900;2015-11-10;CLI00755;FACTURA;14;2;28449;5405;33854
FAC0039901;2015-08-08;CLI00551;FACTURA;5;2;54142;10287;64429
FAC0039902;2015-01-24;CLI00117;FACTURA;41;2;85347;16216;101563
FAC0039903;2015-10-10;CLI00391;FACTURA;41;2;71670;13617;85287
FAC0039904;2015-03-29;CLI00375;FACTURA;37;2;30603;5815;36418
FAC0039905;2015-05-18;CLI00708;FACTURA;37;1;160111;30421;190532
FAC0039906;2015-04-14;CLI00528;FACTURA;16;1;75894;14420;90314
FAC0039907;2015-07-12;CLI00068;FACTURA;7;1;75568;14358;89926
FAC0039908;2015-07-02;CLI00904;FACTURA;29;1;224888;42729;267617
FAC0039909;2015-12-12;CLI00083;FACTURA;6;2;61029;11596;72625
FAC0039910;2015-04-15;CLI00368;FACTURA;14;1;27071;5143;32214
FAC0039911;2015-12-18;CLI00156;FACTURA;17;1;222012;42182;264194
FAC0039912;2015-02-15;CLI00355;FACTURA;5;2;6170;1172;7342
FAC0039913;2015-06-07;CLI00775;FACTURA;42;2;152838;29039;181877
FAC0039914;2015-07-23;CLI00229;FACTURA;18;2;201470;38279;239749
FAC0039915;2015-08-26;CLI00926;FACTURA;14;1;224888;42729;267617
FAC0039916;2015-07-23;CLI00229;FACTURA;19;2;347100;65949;413049
FAC0039917;2015-11-08;CLI00042;FACTURA;15;1;85347;16216;101563
FAC0039918;2015-10-11;CLI00574;FACTURA;45;1;8448;1605;10053
FAC0039919;2015-10-11;CLI00533;FACTURA;49;2;94485;17952;112437
FAC0039920;2015-09-12;CLI00885;FACTURA;28;2;66618;12657;79275
FAC0039921;2015-06-20;CLI00257;FACTURA;7;2;73353;13937;87290
FAC0039922;2015-04-08;CLI00285;FACTURA;34;2;112444;21364;133808
FAC0039923;2015-11-20;CLI00424;FACTURA;46;1;175554;33355;208909
FAC0039924;2015-08-19;CLI00820;FACTURA;1;1;81372;15461;96833
FAC0039925;2015-03-30;CLI00322;FACTURA;29;1;91632;17410;109042
FAC0039926;2015-12-08;CLI00404;FACTURA;43;1;181323;34451;215774
FAC0039927;2015-08-26;CLI00895;FACTURA;1;2;109295;20766;130061
FAC0039928;2015-03-29;CLI00103;FACTURA;12;2;160350;30467;190817
FAC0039929;2015-07-29;CLI00205;FACTURA;9;2;177648;33753;211401
FAC0039930;2015-05-28;CLI00993;FACTURA;38;2;27709;5265;32974
FAC0039931;2015-05-14;CLI00445;FACTURA;1;2;34187;6496;40683
FAC0039932;2015-02-23;CLI00038;FACTURA;24;1;30438;5783;36221
FAC0039933;2015-12-27;CLI00457;FACTURA;18;2;108972;20705;129677
FAC0039934;2015-05-10;CLI00215;FACTURA;2;2;80588;15312;95900
FAC0039935;2015-08-24;CLI00860;FACTURA;25;1;50730;9639;60369
FAC0039936;2015-04-22;CLI01000;FACTURA;31;1;74004;14061;88065
FAC0039937;2015-09-09;CLI00569;FACTURA;18;2;47415;9009;56424
FAC0039938;2015-05-14;CLI00238;FACTURA;17;1;130830;24858;155688
FAC0039939;2015-10-26;CLI00138;FACTURA;26;1;82044;15588;97632
FAC0039940;2015-04-01;CLI00519;FACTURA;48;2;212664;40406;253070
FAC0039941;2015-05-05;CLI00657;FACTURA;30;2;69420;13190;82610
FAC0039942;2015-07-05;CLI00568;FACTURA;1;1;94485;17952;112437
FAC0039943;2015-02-08;CLI00666;FACTURA;34;1;114672;21788;136460
FAC0039944;2015-11-26;CLI00459;FACTURA;16;2;39466;7499;46965
FAC0039945;2015-03-28;CLI00713;FACTURA;6;2;203021;38574;241595
FAC0039946;2015-06-12;CLI00573;FACTURA;18;2;59585;11321;70906
FAC0039947;2015-01-30;CLI00248;FACTURA;47;1;142540;27083;169623
FAC0039948;2015-11-04;CLI00595;FACTURA;12;2;174020;33064;207084
FAC0039949;2015-11-07;CLI00701;FACTURA;1;2;136542;25943;162485
FAC0039950;2015-01-18;CLI00769;FACTURA;7;2;226390;43014;269404
FAC0039951;2015-11-15;CLI00907;FACTURA;17;2;196245;37287;233532
FAC0039952;2015-08-09;CLI00385;FACTURA;36;2;239309;45469;284778
FAC0039953;2015-08-03;CLI00817;FACTURA;16;2;10479;1991;12470
FAC0039954;2015-01-07;CLI00162;FACTURA;32;1;109025;20715;129740
FAC0039955;2015-04-27;CLI00051;FACTURA;14;2;102010;19382;121392
FAC0039956;2015-10-07;CLI00587;FACTURA;12;2;39466;7499;46965
FAC0039957;2015-02-19;CLI00747;FACTURA;17;2;52908;10053;62961
FAC0039958;2015-11-21;CLI00775;FACTURA;12;2;148008;28122;176130
FAC0039959;2015-02-15;CLI00496;FACTURA;30;1;97530;18531;116061
FAC0039960;2015-03-22;CLI00392;FACTURA;29;1;112952;21461;134413
FAC0039961;2015-07-03;CLI00821;FACTURA;6;2;141029;26796;167825
FAC0039962;2015-03-26;CLI00356;FACTURA;20;1;19506;3706;23212
FAC0039963;2015-03-06;CLI00094;FACTURA;6;1;76218;14481;90699
FAC0039964;2015-06-04;CLI00333;FACTURA;18;2;22908;4353;27261
FAC0039965;2015-06-14;CLI00768;FACTURA;39;1;71022;13494;84516
FAC0039966;2015-07-12;CLI00534;FACTURA;7;1;138545;26324;164869
FAC0039967;2015-06-23;CLI00328;FACTURA;48;1;28508;5417;33925
FAC0039968;2015-02-19;CLI00312;FACTURA;45;1;106332;20203;126535
FAC0039969;2015-10-23;CLI00296;FACTURA;19;1;88824;16877;105701
FAC0039970;2015-05-03;CLI00158;FACTURA;8;1;79749;15152;94901
FAC0039971;2015-03-30;CLI00177;FACTURA;22;2;39012;7412;46424
FAC0039972;2015-02-08;CLI00379;FACTURA;2;2;243639;46291;289930
FAC0039973;2015-11-26;CLI00133;FACTURA;20;2;61206;11629;72835
FAC0039974;2015-12-28;CLI00426;FACTURA;29;1;69420;13190;82610
FAC0039975;2015-07-10;CLI00861;FACTURA;39;2;105816;20105;125921
FAC0039976;2015-11-11;CLI00977;FACTURA;17;2;67584;12841;80425
FAC0039977;2015-06-22;CLI00817;FACTURA;11;2;152838;29039;181877
FAC0039978;2015-05-02;CLI00894;FACTURA;17;1;136542;25943;162485
FAC0039979;2015-05-27;CLI00027;FACTURA;3;2;151788;28840;180628
FAC0039980;2015-03-02;CLI00116;FACTURA;36;1;22639;4301;26940
FAC0039981;2015-03-29;CLI00512;FACTURA;28;1;50946;9680;60626
FAC0039982;2015-09-08;CLI00762;FACTURA;29;1;39012;7412;46424
FAC0039983;2015-01-06;CLI00551;FACTURA;2;2;126490;24033;150523
FAC0039984;2015-12-11;CLI00405;FACTURA;7;2;217944;41409;259353
FAC0039985;2015-12-03;CLI00672;FACTURA;43;1;76032;14446;90478
FAC0039986;2015-05-02;CLI00134;FACTURA;6;1;66381;12612;78993
FAC0039987;2015-06-20;CLI00977;FACTURA;47;2;190701;36233;226934
FAC0039988;2015-08-24;CLI00412;FACTURA;23;1;211170;40122;251292
FAC0039989;2015-10-15;CLI00862;FACTURA;33;1;203784;38719;242503
FAC0039990;2015-12-07;CLI00158;FACTURA;22;1;18892;3589;22481
FAC0039991;2015-05-28;CLI00664;FACTURA;48;1;117036;22237;139273
FAC0039992;2015-08-19;CLI00259;FACTURA;8;2;88824;16877;105701
FAC0039993;2015-10-29;CLI00787;FACTURA;47;2;50946;9680;60626
FAC0039994;2015-12-06;CLI00208;FACTURA;41;1;29003;5511;34514
FAC0039995;2015-01-29;CLI00383;FACTURA;10;2;58006;11021;69027
FAC0039996;2015-05-17;CLI00788;FACTURA;21;1;104412;19838;124250
FAC0039997;2015-10-08;CLI00829;FACTURA;45;2;265830;50508;316338
FAC0039998;2015-09-10;CLI00624;FACTURA;14;1;47676;9058;56734
FAC0039999;2015-05-07;CLI00811;FACTURA;12;2;135376;25721;161097
FAC0040000;2015-01-31;CLI00183;FACTURA;26;2;245187;46586;291773
